# A POS tag dictionary that's used as an addition (or as a fix) to catalan.dict
# These words are candidates to be added (or fixed) in catalan.dict in the future
# File Encoding: UTF-8
# Format: fullform baseform postags (tab separated)
########## Dictionary fixes ##########
########## Additions ##########
Cadafalch	Cadafalch	NPCNSP0
Hopkins	Hopkins	NPCNSP0
Ilamatepec	Ilamatepec	NPMSG00
TikTok	TikTok	NPMSO00
biopel·lícula	biopel·lícula	NCFS000
biopel·lícules	biopel·lícula	NCFP000
fòmit	fòmit	NCMS000
fòmits	fòmit	NCMP000
infomediari	infomediari	NCMS000
infomediaris	infomediari	NCMP000
infomediària	infomediari	NCFS000
infomediàries	infomediari	NCFP000
tiktok	tiktok	NCMS000
tiktoks	tiktok	NCMP000
