atáid	bí	Verb:VI:PresInd:3P:Pl:Rel:CM
tsail	sail	Noun:Fem:Com:Sg:DefArt
tsaofa	saobhadh	Noun:Masc:Gen:Sg:DefArt
tsean	sean	Noun:Masc:Gen:Sg:DefArt
tsliasaid	sliasaid	Noun:Fem:Com:Sg:DefArt
tsleasa	slios	Noun:Masc:Gen:Sg:DefArt
tsniodh	sniodh	Noun:Fem:Com:Sg:DefArt
tsaibhir	saibhir	Noun:Masc:Gen:Sg:DefArt
tsaibhre	saibhre	Noun:Fem:Com:Sg:DefArt
tsaibhrithe	saibhriú	Noun:Masc:Gen:Sg:DefArt
tsaibhris	saibhreas	Noun:Masc:Gen:Sg:DefArt
tsaibhseálaí	saibhseálaí	Noun:Masc:Gen:Sg:DefArt
tsaicín	saicín	Noun:Masc:Gen:Sg:DefArt
tsaidhbhéir	saidhbhéar	Noun:Masc:Gen:Sg:DefArt
tsaidhleora	saidhleoir	Noun:Masc:Gen:Sg:DefArt
tsaidhlín	saidhlín	Noun:Masc:Gen:Sg:DefArt
tsaidléara	saidléir	Noun:Masc:Gen:Sg:DefArt
tsaifír	saifír	Noun:Fem:Com:Sg:DefArt
tsaighead	saighead	Noun:Fem:Com:Sg:DefArt
tsaighdeoireacht	saighdeoireacht	Noun:Fem:Com:Sg:DefArt
tsaighdeora	saighdeoir	Noun:Masc:Gen:Sg:DefArt
tsaighdiúireacht	saighdiúireacht	Noun:Fem:Com:Sg:DefArt
tsaighdiúra	saighdiúir	Noun:Masc:Gen:Sg:DefArt
tsaighdte	saighdeadh	Noun:Masc:Gen:Sg:DefArt
tsaighneoireacht	saighneoireacht	Noun:Fem:Com:Sg:DefArt
tsaighneora	saighneoir	Noun:Masc:Gen:Sg:DefArt
tsaighneáin	saighneán	Noun:Masc:Gen:Sg:DefArt
tsaighthigh	saightheach	Noun:Masc:Gen:Sg:DefArt
tsaileacháin	saileachán	Noun:Masc:Gen:Sg:DefArt
tsaileach	saileach	Noun:Fem:Com:Sg:DefArt
tsailearnach	sailearnach	Noun:Fem:Com:Sg:DefArt
tsaileog	saileog	Noun:Fem:Com:Sg:DefArt
tsaileánaigh	saileánach	Noun:Masc:Gen:Sg:DefArt
tsaileáin	saileán	Noun:Masc:Gen:Sg:DefArt
tsailéid	sailéad	Noun:Masc:Gen:Sg:DefArt
tsailíocht	sailíocht	Noun:Fem:Com:Sg:DefArt
tsailíona	sailíona	Noun:Masc:Gen:Sg:DefArt
tsailíneacht	sailíneacht	Noun:Fem:Com:Sg:DefArt
tsailbhe	sailbhe	Noun:Fem:Com:Sg:DefArt
tsailchearnach	sailchearnach	Noun:Fem:Com:Sg:DefArt
tsailchuach	sailchuach	Noun:Fem:Com:Sg:DefArt
tsailghréasa	sailghréas	Noun:Masc:Gen:Sg:DefArt
tsaillteacht	saillteacht	Noun:Fem:Com:Sg:DefArt
tsaillteora	saillteoir	Noun:Masc:Gen:Sg:DefArt
tsaillte	sailleadh	Noun:Masc:Gen:Sg:DefArt
tsaill	saill	Noun:Fem:Com:Sg:DefArt
tsailmí	sailmí	Noun:Masc:Gen:Sg:DefArt
tsailpítir	sailpítear	Noun:Masc:Gen:Sg:DefArt
tsailtír	sailtír	Noun:Fem:Com:Sg:DefArt
tsail	sail	Noun:Fem:Com:Sg:DefArt
tsaimít	saimít	Noun:Fem:Com:Sg:DefArt
tsain-chomhlíonta	sain-chomhlíonadh	Noun:Masc:Gen:Sg:DefArt
tsainaicme	sainaicme	Noun:Fem:Com:Sg:DefArt
tsaineithne	saineithne	Noun:Fem:Com:Sg:DefArt
tsaineolaíocht	saineolaíocht	Noun:Fem:Com:Sg:DefArt
tsaineolaí	saineolaí	Noun:Masc:Gen:Sg:DefArt
tsaineolais	saineolas	Noun:Masc:Gen:Sg:DefArt
tsaine	saine	Noun:Fem:Com:Sg:DefArt
tsainiúlacht	sainiúlacht	Noun:Fem:Com:Sg:DefArt
tsainithe	sainiú	Noun:Masc:Gen:Sg:DefArt
tsainoidhreacht	sainoidhreacht	Noun:Fem:Com:Sg:DefArt
tsainoidhrithe	sainoidhriú	Noun:Masc:Gen:Sg:DefArt
tsainordaithigh	sainordaitheach	Noun:Masc:Gen:Sg:DefArt
tsainordú	sainordú	Noun:Masc:Gen:Sg:DefArt
tsainuimhir	sainuimhir	Noun:Fem:Com:Sg:DefArt
tsaincheardaíocht	saincheardaíocht	Noun:Fem:Com:Sg:DefArt
tsaincheird	saincheird	Noun:Fem:Com:Sg:DefArt
tsaincheist	saincheist	Noun:Fem:Com:Sg:DefArt
tsainchodáin	sainchodán	Noun:Masc:Gen:Sg:DefArt
tsainchomhartha	sainchomhartha	Noun:Masc:Gen:Sg:DefArt
tsainchothromóid	sainchothromóid	Noun:Fem:Com:Sg:DefArt
tsainchumais	sainchumas	Noun:Masc:Gen:Sg:DefArt
tsainchuntais	sainchuntas	Noun:Masc:Gen:Sg:DefArt
tsainchuspóra	sainchuspóir	Noun:Masc:Gen:Sg:DefArt
tsainchónaíithe	sainchónaí	Noun:Masc:Gen:Sg:DefArt
tsainchreidimh	sainchreideamh	Noun:Masc:Gen:Sg:DefArt
tsainfheidhm	sainfheidhm	Noun:Fem:Com:Sg:DefArt
tsainfhréamh	sainfhréamh	Noun:Fem:Com:Sg:DefArt
tsainghné	sainghné	Noun:Fem:Com:Sg:DefArt
tsaingil	saingeal	Noun:Masc:Gen:Sg:DefArt
tsainleighis	sainleigheas	Noun:Masc:Gen:Sg:DefArt
tsainmhairc	sainmharc	Noun:Masc:Gen:Sg:DefArt
tsainmheáchain	sainmheáchan	Noun:Masc:Gen:Sg:DefArt
tsainmhínithe	sainmhíniú	Noun:Masc:Gen:Sg:DefArt
tsainsiléir	sainsiléar	Noun:Masc:Gen:Sg:DefArt
tsainstaidéir	sainstaidéar	Noun:Masc:Gen:Sg:DefArt
tsainteasa	sainteas	Noun:Masc:Gen:Sg:DefArt
tsainteora	sainteoir	Noun:Masc:Gen:Sg:DefArt
tsaintoillidh	saintoilleadh	Noun:Masc:Gen:Sg:DefArt
tsaint	saint	Noun:Fem:Com:Sg:DefArt
tsairdín	sairdín	Noun:Masc:Gen:Sg:DefArt
tsairse	sairse	Noun:Fem:Com:Sg:DefArt
tsairsínéid	sairsínéad	Noun:Masc:Gen:Sg:DefArt
tsairsín	sairsín	Noun:Masc:Gen:Sg:DefArt
tsais	sais	Noun:Fem:Com:Sg:DefArt
tsaitín	saitín	Noun:Masc:Gen:Sg:DefArt
tsaithe	saithe	Noun:Fem:Com:Sg:DefArt
tsaithnín	saithnín	Noun:Masc:Gen:Sg:DefArt
tsaitsil	saitsil	Noun:Masc:Gen:Sg:DefArt
tsaíocht	saíocht	Noun:Fem:Com:Sg:DefArt
tsaíán	saíán	Noun:Masc:Gen:Sg:DefArt
tsabaitéireacht	sabaitéireacht	Noun:Fem:Com:Sg:DefArt
tsabaitéara	sabaitéir	Noun:Masc:Gen:Sg:DefArt
tsabóidire	sabóidire	Noun:Masc:Gen:Sg:DefArt
tsabóid	sabóid	Noun:Fem:Com:Sg:DefArt
tsabhaircín	sabhaircín	Noun:Masc:Gen:Sg:DefArt
tsabhaill	sabhall	Noun:Masc:Gen:Sg:DefArt
tsabhána	sabhána	Noun:Masc:Gen:Sg:DefArt
tsabháin	sabhán	Noun:Masc:Gen:Sg:DefArt
tsabhdánaigh	sabhdánach	Noun:Masc:Gen:Sg:DefArt
tsabhdáin	sabhdán	Noun:Masc:Gen:Sg:DefArt
tsabhrain	sabhran	Noun:Masc:Gen:Sg:DefArt
tsabhsaí	sabhsaí	Noun:Masc:Gen:Sg:DefArt
tsabhsa	sabhsa	Noun:Masc:Gen:Sg:DefArt
tsaaía	sabh	Noun:Masc:Gen:Sg:DefArt
tsacadáin	sacadán	Noun:Masc:Gen:Sg:DefArt
tsacannáin	sacannán	Noun:Masc:Gen:Sg:DefArt
tsacair	sacar	Noun:Masc:Gen:Sg:DefArt
tsacáin	sacán	Noun:Masc:Gen:Sg:DefArt
tsacéadaigh	sacéadach	Noun:Masc:Gen:Sg:DefArt
tsacraifís	sacraifís	Noun:Fem:Com:Sg:DefArt
tsacrailéid	sacrailéid	Noun:Fem:Com:Sg:DefArt
tsacraimint	sacraimint	Noun:Fem:Com:Sg:DefArt
tsacraisteora	sacraisteoir	Noun:Masc:Gen:Sg:DefArt
tsacraistí	sacraistí	Noun:Masc:Gen:Sg:DefArt
tsacraim	sacram	Noun:Masc:Gen:Sg:DefArt
tsacráir	sacráir	Noun:Fem:Com:Sg:DefArt
tsacrása	sacrás	Noun:Masc:Gen:Sg:DefArt
tsacsafónaí	sacsafónaí	Noun:Masc:Gen:Sg:DefArt
tsacsafóin	sacsafón	Noun:Masc:Gen:Sg:DefArt
tsacschoirn	sacschorn	Noun:Masc:Gen:Sg:DefArt
tsacshrathair	sacshrathair	Noun:Fem:Com:Sg:DefArt
tsactha	sacadh	Noun:Masc:Gen:Sg:DefArt
tsadaill	sadall	Noun:Masc:Gen:Sg:DefArt
tsadhlann	sadhlann	Noun:Fem:Com:Sg:DefArt
tsadhlais	sadhlas	Noun:Masc:Gen:Sg:DefArt
tsadhsóireacht	sadhsóireacht	Noun:Fem:Com:Sg:DefArt
tsadhsóra	sadhsóir	Noun:Masc:Gen:Sg:DefArt
tsagartacht	sagartacht	Noun:Fem:Com:Sg:DefArt
tsagartúlacht	sagartúlacht	Noun:Fem:Com:Sg:DefArt
tsagairt	sagart	Noun:Masc:Gen:Sg:DefArt
tsaghais	saghas	Noun:Masc:Gen:Sg:DefArt
tsaghdair	saghdar	Noun:Masc:Gen:Sg:DefArt
tsalaicioláit	salaicioláit	Noun:Fem:Com:Sg:DefArt
tsalaicil	salaicil	Noun:Fem:Com:Sg:DefArt
tsalaicin	salaicin	Noun:Fem:Com:Sg:DefArt
tsalaid	salaid	Noun:Masc:Gen:Sg:DefArt
tsalaitheora	salaitheoir	Noun:Masc:Gen:Sg:DefArt
tsalacharaíl	salacharaíl	Noun:Fem:Com:Sg:DefArt
tsalachair	salachar	Noun:Masc:Gen:Sg:DefArt
tsalamandair	salamandar	Noun:Masc:Gen:Sg:DefArt
tsalandacht	salandacht	Noun:Fem:Com:Sg:DefArt
tsalannlusa	salannlus	Noun:Masc:Gen:Sg:DefArt
tsalainn	salann	Noun:Masc:Gen:Sg:DefArt
tsaláin	salán	Noun:Masc:Gen:Sg:DefArt
tsalóin	salón	Noun:Masc:Gen:Sg:DefArt
tsalúin	salún	Noun:Masc:Gen:Sg:DefArt
tsalmaireacht	salmaireacht	Noun:Fem:Com:Sg:DefArt
tsalmaire	salmaire	Noun:Masc:Gen:Sg:DefArt
tsalmcheadail	salmcheadal	Noun:Masc:Gen:Sg:DefArt
tsalsaibh	salsabh	Noun:Masc:Gen:Sg:DefArt
tsaltair	saltair	Noun:Fem:Com:Sg:DefArt
tsaltaithe	saltú	Noun:Masc:Gen:Sg:DefArt
tsalaithe	salú	Noun:Masc:Gen:Sg:DefArt
tsamairiam	samairiam	Noun:Masc:Gen:Sg:DefArt
tsamabháir	samabhár	Noun:Masc:Gen:Sg:DefArt
tsamáir	samár	Noun:Masc:Gen:Sg:DefArt
tsamúraí	samúraí	Noun:Masc:Gen:Sg:DefArt
tsambó	sambó	Noun:Masc:Gen:Sg:DefArt
tsamhailchomhartha	samhailchomhartha	Noun:Masc:Gen:Sg:DefArt
tsamhailghrian	samhailghrian	Noun:Fem:Com:Sg:DefArt
tsamhail	samhail	Noun:Fem:Com:Sg:DefArt
tsamhairle	samhairle	Noun:Masc:Gen:Sg:DefArt
tsamhaiscigh	samhaisceach	Noun:Masc:Gen:Sg:DefArt
tsamhaisc	samhaisc	Noun:Fem:Com:Sg:DefArt
tsamhaltacht	samhaltacht	Noun:Fem:Com:Sg:DefArt
tsamhaltais	samhaltas	Noun:Masc:Gen:Sg:DefArt
tsamhaltáin	samhaltán	Noun:Masc:Gen:Sg:DefArt
tsamhaidh	samhadh	Noun:Masc:Gen:Sg:DefArt
tsamhóg	samhóg	Noun:Fem:Com:Sg:DefArt
tsamhdaí	samhdaí	Noun:Masc:Gen:Sg:DefArt
tsamhdáin	samhdán	Noun:Masc:Gen:Sg:DefArt
tsamhdóg	samhdóg	Noun:Fem:Com:Sg:DefArt
tsamhlaíocht	samhlaíocht	Noun:Fem:Com:Sg:DefArt
tsamhlachais	samhlachas	Noun:Masc:Gen:Sg:DefArt
tsamhlacháin	samhlachán	Noun:Masc:Gen:Sg:DefArt
tsamhlaoid	samhlaoid	Noun:Fem:Com:Sg:DefArt
tsamhlaithe	samhlú	Noun:Masc:Gen:Sg:DefArt
tsamhnacháin	samhnachán	Noun:Masc:Gen:Sg:DefArt
tsamhnais	samhnas	Noun:Masc:Gen:Sg:DefArt
tsamhraidh	samhradh	Noun:Masc:Gen:Sg:DefArt
tsamhraithe	samhrú	Noun:Masc:Gen:Sg:DefArt
tsampla	sampla	Noun:Masc:Gen:Sg:DefArt
tsampláil	sampláil	Noun:Fem:Com:Sg:DefArt
tsamplóireacht	samplóireacht	Noun:Fem:Com:Sg:DefArt
tsamplóra	samplóir	Noun:Masc:Gen:Sg:DefArt
tsanasaíocht	sanasaíocht	Noun:Fem:Com:Sg:DefArt
tsanasaí	sanasaí	Noun:Masc:Gen:Sg:DefArt
tsanasánaí	sanasánaí	Noun:Masc:Gen:Sg:DefArt
tsanasáin	sanasán	Noun:Masc:Gen:Sg:DefArt
tsanatóra	sanatóir	Noun:Masc:Gen:Sg:DefArt
tsanais	sanas	Noun:Masc:Gen:Sg:DefArt
tsanctóra	sanctóir	Noun:Masc:Gen:Sg:DefArt
tsandaraic	sandarac	Noun:Masc:Gen:Sg:DefArt
tsannaí	sannaí	Noun:Masc:Gen:Sg:DefArt
tsannóra	sannóir	Noun:Masc:Gen:Sg:DefArt
tsantacháin	santachán	Noun:Masc:Gen:Sg:DefArt
tsantacht	santacht	Noun:Fem:Com:Sg:DefArt
tsantail	santal	Noun:Masc:Gen:Sg:DefArt
tsantaithe	santú	Noun:Masc:Gen:Sg:DefArt
tsapaisiú	sapaisiú	Noun:Masc:Gen:Sg:DefArt
tsapair	sapar	Noun:Masc:Gen:Sg:DefArt
tsapraifít	sapraifít	Noun:Fem:Com:Sg:DefArt
tsaprailít	saprailít	Noun:Fem:Com:Sg:DefArt
tsaraifín	saraifín	Noun:Masc:Gen:Sg:DefArt
tsaraiglí	saraiglí	Noun:Masc:Gen:Sg:DefArt
tsaraiste	saraiste	Noun:Fem:Com:Sg:DefArt
tsaraí	saraí	Noun:Masc:Gen:Sg:DefArt
tsarabainn	sarabann	Noun:Masc:Gen:Sg:DefArt
tsaracháin	sarachán	Noun:Masc:Gen:Sg:DefArt
tsaranáidí	saranáidí	Noun:Masc:Gen:Sg:DefArt
tsaranáid	saranáid	Noun:Fem:Com:Sg:DefArt
tsaraing	sarang	Noun:Masc:Gen:Sg:DefArt
tsarcaileime	sarcaileime	Noun:Fem:Com:Sg:DefArt
tsarceolaíocht	sarceolaíocht	Noun:Fem:Com:Sg:DefArt
tsarcóis	sarcóis	Noun:Fem:Com:Sg:DefArt
tsarcóma	sarcóma	Noun:Masc:Gen:Sg:DefArt
tsardoinisc	sardoinisc	Noun:Fem:Com:Sg:DefArt
tsarsparail	sarsparail	Noun:Fem:Com:Sg:DefArt
tsasafrais	sasafras	Noun:Masc:Gen:Sg:DefArt
tsastrúga	sastrúga	Noun:Masc:Gen:Sg:DefArt
tsatailít	satailít	Noun:Fem:Com:Sg:DefArt
tsatailt	satailt	Noun:Fem:Com:Sg:DefArt
tsatair	satair	Noun:Masc:Gen:Sg:DefArt
tsathaoide	sathaoide	Noun:Fem:Com:Sg:DefArt
tsatraip	satrap	Noun:Masc:Gen:Sg:DefArt
tsaeis	saeis	Noun:Fem:Com:Sg:DefArt
tsaeraic	saerac	Noun:Masc:Gen:Sg:DefArt
tsaoire	saoire	Noun:Fem:Com:Sg:DefArt
tsaoirseacht	saoirseacht	Noun:Fem:Com:Sg:DefArt
tsaoirse	saoirse	Noun:Fem:Com:Sg:DefArt
tsaoirsigh	saoirseach	Noun:Masc:Gen:Sg:DefArt
tsaoisteog	saoisteog	Noun:Fem:Com:Sg:DefArt
tsaoiste	saoiste	Noun:Masc:Gen:Sg:DefArt
tsaoistíocht	saoistíocht	Noun:Fem:Com:Sg:DefArt
tsaoithiúlacht	saoithiúlacht	Noun:Fem:Com:Sg:DefArt
tsaoithíneacht	saoithíneacht	Noun:Fem:Com:Sg:DefArt
tsaoithín	saoithín	Noun:Masc:Gen:Sg:DefArt
tsaoi	saoi	Noun:Masc:Gen:Sg:DefArt
tsaobhchiall	saobhchiall	Noun:Fem:Com:Sg:DefArt
tsaobhchreidimh	saobhchreideamh	Noun:Masc:Gen:Sg:DefArt
tsaobhchrábhaidh	saobhchrábhadh	Noun:Masc:Gen:Sg:DefArt
tsaobhdhiallais	saobhdhiallas	Noun:Masc:Gen:Sg:DefArt
tsaobhghaoth	saobhghaoth	Noun:Fem:Com:Sg:DefArt
tsaobhgháire	saobhgháire	Noun:Masc:Gen:Sg:DefArt
tsaobhghrá	saobhghrá	Noun:Masc:Gen:Sg:DefArt
tsaobhnóis	saobhnós	Noun:Masc:Gen:Sg:DefArt
tsaofacht	saofacht	Noun:Fem:Com:Sg:DefArt
tsaofóra	saofóir	Noun:Masc:Gen:Sg:DefArt
tsaolaí	saolaí	Noun:Masc:Gen:Sg:DefArt
tsaolacht	saolacht	Noun:Fem:Com:Sg:DefArt
tsaolú	saolú	Noun:Masc:Gen:Sg:DefArt
tsaolré	saolré	Noun:Fem:Com:Sg:DefArt
tsaoltacht	saoltacht	Noun:Fem:Com:Sg:DefArt
tsaontacht	saontacht	Noun:Fem:Com:Sg:DefArt
tsaor-reic	saor-reic	Noun:Fem:Com:Sg:DefArt
tsaor-rotha	saor-roth	Noun:Masc:Gen:Sg:DefArt
tsaoroideachais	saoroideachas	Noun:Masc:Gen:Sg:DefArt
tsaoráidí	saoráidí	Noun:Fem:Com:Sg:DefArt
tsaoráid	saoráid	Noun:Fem:Com:Sg:DefArt
tsaoráil	saoráil	Noun:Fem:Com:Sg:DefArt
tsaorálaí	saorálaí	Noun:Masc:Gen:Sg:DefArt
tsaoránacht	saoránacht	Noun:Fem:Com:Sg:DefArt
tsaoránaigh	saoránach	Noun:Masc:Gen:Sg:DefArt
tsaorbhoird	saorbhord	Noun:Masc:Gen:Sg:DefArt
tsaorbhreithiúnais	saorbhreithiúnas	Noun:Masc:Gen:Sg:DefArt
tsaorcheada	saorchead	Noun:Masc:Gen:Sg:DefArt
tsaorchic	saorchic	Noun:Fem:Com:Sg:DefArt
tsaorchlann	saorchlann	Noun:Fem:Com:Sg:DefArt
tsaorchonartha	saorchonradh	Noun:Masc:Gen:Sg:DefArt
tsaordhréachta	saordhréacht	Noun:Masc:Gen:Sg:DefArt
tsaorfhir	saorfhear	Noun:Masc:Gen:Sg:DefArt
tsaorgacht	saorgacht	Noun:Fem:Com:Sg:DefArt
tsaorghabhálaí	saorghabhálaí	Noun:Masc:Gen:Sg:DefArt
tsaorghabháltais	saorghabháltas	Noun:Masc:Gen:Sg:DefArt
tsaorghlanta	saorghlanadh	Noun:Masc:Gen:Sg:DefArt
tsaorlíníocht	saorlíníocht	Noun:Fem:Com:Sg:DefArt
tsaormhaithiúnais	saormhaithiúnas	Noun:Masc:Gen:Sg:DefArt
tsaormheadaracht	saormheadaracht	Noun:Fem:Com:Sg:DefArt
tsaormheasa	saormheas	Noun:Masc:Gen:Sg:DefArt
tsaorphoic	saorphoc	Noun:Masc:Gen:Sg:DefArt
tsaorphoirt	saorphort	Noun:Masc:Gen:Sg:DefArt
tsaorshealbhóra	saorshealbhóir	Noun:Masc:Gen:Sg:DefArt
tsaorsheilbh	saorsheilbh	Noun:Fem:Com:Sg:DefArt
tsaorshleachta	saorshliocht	Noun:Masc:Gen:Sg:DefArt
tsaorstáit	saorstát	Noun:Masc:Gen:Sg:DefArt
tsaorthaistil	saorthaisteal	Noun:Masc:Gen:Sg:DefArt
tsaorthoil	saorthoil	Noun:Fem:Com:Sg:DefArt
tsaorthurais	saorthuras	Noun:Masc:Gen:Sg:DefArt
tsaorthéarma	saorthéarma	Noun:Masc:Gen:Sg:DefArt
tsaorthóra	saorthóir	Noun:Masc:Gen:Sg:DefArt
tsaorthrádáil	saorthrádáil	Noun:Fem:Com:Sg:DefArt
tsaorthrádálaí	saorthrádálaí	Noun:Masc:Gen:Sg:DefArt
tsaothanáil	saothanáil	Noun:Fem:Com:Sg:DefArt
tsaotharcáin	saotharcán	Noun:Masc:Gen:Sg:DefArt
tsaotharlann	saotharlann	Noun:Fem:Com:Sg:DefArt
tsaothair	saothar	Noun:Masc:Gen:Sg:DefArt
tsaothraíocht	saothraíocht	Noun:Fem:Com:Sg:DefArt
tsaothraí	saothraí	Noun:Masc:Gen:Sg:DefArt
tsaothráin	saothrán	Noun:Masc:Gen:Sg:DefArt
tsaothrúcháin	saothrúchán	Noun:Masc:Gen:Sg:DefArt
tsaothrú	saothrú	Noun:Masc:Gen:Sg:DefArt
tsaothraithe	saothrú	Noun:Masc:Gen:Sg:DefArt
tsaotha	saoth	Noun:Masc:Gen:Sg:DefArt
tsaotrúin	saotrún	Noun:Masc:Gen:Sg:DefArt
tsaoil	saol	Noun:Masc:Gen:Sg:DefArt
tsaoir	saor	Noun:Masc:Gen:Sg:DefArt
tsaic	sac	Noun:Masc:Gen:Sg:DefArt
tsailm	salm	Noun:Masc:Gen:Sg:DefArt
tsaird	sard	Noun:Masc:Gen:Sg:DefArt
tseaicéid	seaicéad	Noun:Masc:Gen:Sg:DefArt
tseaimféir	seaimféar	Noun:Masc:Gen:Sg:DefArt
tseaimpéin	seaimpéin	Noun:Masc:Gen:Sg:DefArt
tseaimpín	seaimpín	Noun:Masc:Gen:Sg:DefArt
tseabhaic	seabhac	Noun:Masc:Gen:Sg:DefArt
tseabhcóireacht	seabhcóireacht	Noun:Fem:Com:Sg:DefArt
tseabhcóra	seabhcóir	Noun:Masc:Gen:Sg:DefArt
tseabhdair	seabhdar	Noun:Masc:Gen:Sg:DefArt
tseabhráin	seabhrán	Noun:Masc:Gen:Sg:DefArt
tseacain	seacain	Noun:Fem:Com:Sg:DefArt
tseaca	seaca	Noun:Masc:Gen:Sg:DefArt
tseacáil	seacál	Noun:Masc:Gen:Sg:DefArt
tseacó	seacó	Noun:Masc:Gen:Sg:DefArt
tseach-chonair	seach-chonair	Noun:Fem:Com:Sg:DefArt
tseach-chló	seach-chló	Noun:Masc:Gen:Sg:DefArt
tseachaimiréil	seachaimiréal	Noun:Masc:Gen:Sg:DefArt
tseachaint	seachaint	Noun:Fem:Com:Sg:DefArt
tseachaíocht	seachaíocht	Noun:Fem:Com:Sg:DefArt
tseachadóra	seachadóir	Noun:Masc:Gen:Sg:DefArt
tseachadta	seachadadh	Noun:Masc:Gen:Sg:DefArt
tseachantacht	seachantacht	Noun:Fem:Com:Sg:DefArt
tseachantóra	seachantóir	Noun:Masc:Gen:Sg:DefArt
tseacha	seacha	Noun:Masc:Gen:Sg:DefArt
tseachobair	seachobair	Noun:Fem:Com:Sg:DefArt
tseachfhocail	seachfhocal	Noun:Masc:Gen:Sg:DefArt
tseachghalair	seachghalar	Noun:Masc:Gen:Sg:DefArt
tseachmaill	seachmall	Noun:Masc:Gen:Sg:DefArt
tseachránaí	seachránaí	Noun:Masc:Gen:Sg:DefArt
tseachránacht	seachránacht	Noun:Fem:Com:Sg:DefArt
tseachráin	seachrán	Noun:Masc:Gen:Sg:DefArt
tseachróid	seachród	Noun:Masc:Gen:Sg:DefArt
tseachtain	seachtain	Noun:Fem:Com:Sg:DefArt
tseachtanáin	seachtanán	Noun:Masc:Gen:Sg:DefArt
tseachtaigh	seachtach	Noun:Masc:Gen:Sg:DefArt
tseachtair	seachtar	Noun:Masc:Gen:Sg:DefArt
tseachtódú	seachtódú	Noun:Masc:Gen:Sg:DefArt
tseachtóid	seachtód	Noun:Masc:Gen:Sg:DefArt
tseachtód	seachtó	Noun:Masc:Gen:Sg:DefArt
tseachtú	seachtú	Noun:Masc:Gen:Sg:DefArt
tseachtháirge	seachtháirge	Noun:Masc:Gen:Sg:DefArt
tseachtráin	seachtrán	Noun:Masc:Gen:Sg:DefArt
tseachtraithe	seachtrú	Noun:Masc:Gen:Sg:DefArt
tseacht	seacht	Noun:Masc:Gen:Sg:DefArt
tseachvótáil	seachvótáil	Noun:Fem:Com:Sg:DefArt
tseachvótálaí	seachvótálaí	Noun:Masc:Gen:Sg:DefArt
tseacláid	seacláid	Noun:Fem:Com:Sg:DefArt
tseadaitheora	seadaitheoir	Noun:Masc:Gen:Sg:DefArt
tseadachain	seadachan	Noun:Masc:Gen:Sg:DefArt
tseadeolaíocht	seadeolaíocht	Noun:Fem:Com:Sg:DefArt
tseadánachais	seadánachas	Noun:Masc:Gen:Sg:DefArt
tseadánacht	seadánacht	Noun:Fem:Com:Sg:DefArt
tseadáin	seadán	Noun:Masc:Gen:Sg:DefArt
tseadóg	seadóg	Noun:Fem:Com:Sg:DefArt
tseadbháisteach	seadbháisteach	Noun:Fem:Com:Sg:DefArt
tseadbhraoin	seadbhraon	Noun:Masc:Gen:Sg:DefArt
tseadchabaire	seadchabaire	Noun:Masc:Gen:Sg:DefArt
tseadráil	seadráil	Noun:Fem:Com:Sg:DefArt
tsead	sead	Noun:Fem:Com:Sg:DefArt
tseadaithe	seadú	Noun:Masc:Gen:Sg:DefArt
tseafaid	seafaid	Noun:Fem:Com:Sg:DefArt
tseafóid	seafóid	Noun:Fem:Com:Sg:DefArt
tseafta	seafta	Noun:Masc:Gen:Sg:DefArt
tseagalach	seagalach	Noun:Fem:Com:Sg:DefArt
tseagail	seagal	Noun:Masc:Gen:Sg:DefArt
tseaga	seaga	Noun:Masc:Gen:Sg:DefArt
tseaghais	seaghais	Noun:Fem:Com:Sg:DefArt
tsealaíocht	sealaíocht	Noun:Fem:Com:Sg:DefArt
tsealacháin	sealachán	Noun:Masc:Gen:Sg:DefArt
tsealadóra	sealadóir	Noun:Masc:Gen:Sg:DefArt
tsealaid	sealad	Noun:Masc:Gen:Sg:DefArt
tsealaip	sealap	Noun:Masc:Gen:Sg:DefArt
tsealánaigh	sealánach	Noun:Masc:Gen:Sg:DefArt
tsealáin	sealán	Noun:Masc:Gen:Sg:DefArt
tsealúchais	sealúchas	Noun:Masc:Gen:Sg:DefArt
tsealbhaíocht	sealbhaíocht	Noun:Fem:Com:Sg:DefArt
tsealbhaigh	sealbhach	Noun:Masc:Gen:Sg:DefArt
tsealbháin	sealbhán	Noun:Masc:Gen:Sg:DefArt
tsealbhóra	sealbhóir	Noun:Masc:Gen:Sg:DefArt
tsealbhaithe	sealbhú	Noun:Masc:Gen:Sg:DefArt
tsealgaireacht	sealgaireacht	Noun:Fem:Com:Sg:DefArt
tsealgaire	sealgaire	Noun:Masc:Gen:Sg:DefArt
tsealgáin	sealgán	Noun:Masc:Gen:Sg:DefArt
tsealgóg	sealgóg	Noun:Fem:Com:Sg:DefArt
tsealg	sealg	Noun:Fem:Com:Sg:DefArt
tseallaigh	seallach	Noun:Masc:Gen:Sg:DefArt
tsealla	sealla	Noun:Masc:Gen:Sg:DefArt
tseallóid	seallóid	Noun:Fem:Com:Sg:DefArt
tsealla	seall	Noun:Masc:Gen:Sg:DefArt
tseala	seal	Noun:Masc:Gen:Sg:DefArt
tseamaide	seamaide	Noun:Masc:Gen:Sg:DefArt
tseamaidíl	seamaidíl	Noun:Fem:Com:Sg:DefArt
tseamaí	seamaí	Noun:Masc:Gen:Sg:DefArt
tseamadóra	seamadóir	Noun:Masc:Gen:Sg:DefArt
tseamáin	seamán	Noun:Masc:Gen:Sg:DefArt
tseamhain	seamhan	Noun:Masc:Gen:Sg:DefArt
tseamhair	seamhar	Noun:Masc:Gen:Sg:DefArt
tseamhnáin	seamhnán	Noun:Masc:Gen:Sg:DefArt
tseamlais	seamlas	Noun:Masc:Gen:Sg:DefArt
tseampú	seampú	Noun:Masc:Gen:Sg:DefArt
tseamróg	seamróg	Noun:Fem:Com:Sg:DefArt
tseamsacht	seamsacht	Noun:Fem:Com:Sg:DefArt
tseamsánaí	seamsánaí	Noun:Masc:Gen:Sg:DefArt
tseamsánacht	seamsánacht	Noun:Fem:Com:Sg:DefArt
tseamsáin	seamsán	Noun:Masc:Gen:Sg:DefArt
tseamsóg	seamsóg	Noun:Fem:Com:Sg:DefArt
tseamsúir	seamsúr	Noun:Masc:Gen:Sg:DefArt
tseama	seam	Noun:Masc:Gen:Sg:DefArt
tsean-aintín	sean-aintín	Noun:Fem:Com:Sg:DefArt
tsean-ama	sean-am	Noun:Masc:Gen:Sg:DefArt
tsean-ancaire	sean-ancaire	Noun:Masc:Gen:Sg:DefArt
tsean-ghaineamhchloch	sean-ghaineamhchloch	Noun:Fem:Com:Sg:DefArt
tsean-nóis	sean-nós	Noun:Masc:Gen:Sg:DefArt
tseanaimsearthacht	seanaimsearthacht	Noun:Fem:Com:Sg:DefArt
tseanaimsir	seanaimsir	Noun:Fem:Com:Sg:DefArt
tseanaithne	seanaithne	Noun:Fem:Com:Sg:DefArt
tseanadóireacht	seanadóireacht	Noun:Fem:Com:Sg:DefArt
tseanadóra	seanadóir	Noun:Masc:Gen:Sg:DefArt
tseanama	seanam	Noun:Masc:Gen:Sg:DefArt
tseanascail	seanascal	Noun:Masc:Gen:Sg:DefArt
tseanasclacht	seanasclacht	Noun:Fem:Com:Sg:DefArt
tseanathar	seanathair	Noun:Masc:Gen:Sg:DefArt
tseanaois	seanaois	Noun:Fem:Com:Sg:DefArt
tseanaidh	seanadh	Noun:Masc:Gen:Sg:DefArt
tseanaid	seanad	Noun:Masc:Gen:Sg:DefArt
tseaniarsma	seaniarsma	Noun:Masc:Gen:Sg:DefArt
tseanuncail	seanuncail	Noun:Masc:Gen:Sg:DefArt
tseanársaíocht	seanársaíocht	Noun:Fem:Com:Sg:DefArt
tseanéadaigh	seanéadach	Noun:Masc:Gen:Sg:DefArt
tseanóra	seanóir	Noun:Masc:Gen:Sg:DefArt
tseanórthacht	seanórthacht	Noun:Fem:Com:Sg:DefArt
tseanbhaile	seanbhaile	Noun:Masc:Gen:Sg:DefArt
tseanbhailéid	seanbhailéad	Noun:Masc:Gen:Sg:DefArt
tseanbhaitsiléara	seanbhaitsiléir	Noun:Masc:Gen:Sg:DefArt
tseanbhallóg	seanbhallóg	Noun:Fem:Com:Sg:DefArt
tseanbhoic	seanbhoc	Noun:Masc:Gen:Sg:DefArt
tseanbhuille	seanbhuille	Noun:Masc:Gen:Sg:DefArt
tseanbhunaidh	seanbhunadh	Noun:Masc:Gen:Sg:DefArt
tseanbhuachalla	seanbhuachaill	Noun:Masc:Gen:Sg:DefArt
tseanbhlais	seanbhlas	Noun:Masc:Gen:Sg:DefArt
tseanbhróg	seanbhróg	Noun:Fem:Com:Sg:DefArt
tseanchailín	seanchailín	Noun:Masc:Gen:Sg:DefArt
tseanchailleach	seanchailleach	Noun:Fem:Com:Sg:DefArt
tseanchaint	seanchaint	Noun:Fem:Com:Sg:DefArt
tseanchairt	seanchairt	Noun:Fem:Com:Sg:DefArt
tseanchaíocht	seanchaíocht	Noun:Fem:Com:Sg:DefArt
tseanchaí	seanchaí	Noun:Masc:Gen:Sg:DefArt
tseanchabhail	seanchabhail	Noun:Fem:Com:Sg:DefArt
tseanchais	seanchas	Noun:Masc:Gen:Sg:DefArt
tseanchodlata	seanchodladh	Noun:Masc:Gen:Sg:DefArt
tseanchoilm	seancholm	Noun:Masc:Gen:Sg:DefArt
tseanchuimhne	seanchuimhne	Noun:Fem:Com:Sg:DefArt
tseanchleachtaidh	seanchleachtadh	Noun:Masc:Gen:Sg:DefArt
tseanchnámh	seanchnámh	Noun:Fem:Com:Sg:DefArt
tseanchríonnacht	seanchríonnacht	Noun:Fem:Com:Sg:DefArt
tseanchinn	seancheann	Noun:Masc:Gen:Sg:DefArt
tseandaí	seandaí	Noun:Masc:Gen:Sg:DefArt
tseandacht	seandacht	Noun:Fem:Com:Sg:DefArt
tseandálaíocht	seandálaíocht	Noun:Fem:Com:Sg:DefArt
tseandálaí	seandálaí	Noun:Masc:Gen:Sg:DefArt
tseandéanaimh	seandéanamh	Noun:Masc:Gen:Sg:DefArt
tseandíchill	seandícheall	Noun:Masc:Gen:Sg:DefArt
tseandúshláin	seandúshlán	Noun:Masc:Gen:Sg:DefArt
tseandraoi	seandraoi	Noun:Masc:Gen:Sg:DefArt
tseandreama	seandream	Noun:Masc:Gen:Sg:DefArt
tseanduine	seanduine	Noun:Masc:Gen:Sg:DefArt
tseanfach	seanfach	Noun:Fem:Com:Sg:DefArt
tseanfhaiseantacht	seanfhaiseantacht	Noun:Fem:Com:Sg:DefArt
tseanfharraige	seanfharraige	Noun:Fem:Com:Sg:DefArt
tseanfhocail	seanfhocal	Noun:Masc:Gen:Sg:DefArt
tseanfhondúra	seanfhondúir	Noun:Masc:Gen:Sg:DefArt
tseanfhothraigh	seanfhothrach	Noun:Masc:Gen:Sg:DefArt
tseanfhir	seanfhear	Noun:Masc:Gen:Sg:DefArt
tseangaire	seangaire	Noun:Masc:Gen:Sg:DefArt
tseangacht	seangacht	Noun:Fem:Com:Sg:DefArt
tseangáin	seangán	Noun:Masc:Gen:Sg:DefArt
tseanghealach	seanghealach	Noun:Fem:Com:Sg:DefArt
tseanghoimh	seanghoimh	Noun:Fem:Com:Sg:DefArt
tseanglaigh	seanglach	Noun:Masc:Gen:Sg:DefArt
tseanga	seang	Noun:Masc:Gen:Sg:DefArt
tseanleasaithe	seanleasú	Noun:Masc:Gen:Sg:DefArt
tseanlámh	seanlámh	Noun:Fem:Com:Sg:DefArt
tseanléim	seanléim	Noun:Fem:Com:Sg:DefArt
tseanmóireacht	seanmóireacht	Noun:Fem:Com:Sg:DefArt
tseanmóirí	seanmóirí	Noun:Masc:Gen:Sg:DefArt
tseanmóir	seanmóir	Noun:Fem:Com:Sg:DefArt
tseanmhaighdean	seanmhaighdean	Noun:Fem:Com:Sg:DefArt
tseanmhadra	seanmhadra	Noun:Masc:Gen:Sg:DefArt
tseanmháthair	seanmháthair	Noun:Fem:Com:Sg:DefArt
tseanphinsin	seanphinsean	Noun:Masc:Gen:Sg:DefArt
tseanphlanda	seanphlanda	Noun:Masc:Gen:Sg:DefArt
tseanreachta	seanreacht	Noun:Masc:Gen:Sg:DefArt
tseanriadaire	seanriadaire	Noun:Masc:Gen:Sg:DefArt
tseanruda	seanrud	Noun:Masc:Gen:Sg:DefArt
tseanrá	seanrá	Noun:Masc:Gen:Sg:DefArt
tseanré	seanré	Noun:Fem:Com:Sg:DefArt
tseansaighdiúra	seansaighdiúir	Noun:Masc:Gen:Sg:DefArt
tseansailéireacht	seansailéireacht	Noun:Fem:Com:Sg:DefArt
tseansailéara	seansailéir	Noun:Masc:Gen:Sg:DefArt
tseansaireacht	seansaireacht	Noun:Fem:Com:Sg:DefArt
tseansaoil	seansaol	Noun:Masc:Gen:Sg:DefArt
tseanseadaire	seanseadaire	Noun:Masc:Gen:Sg:DefArt
tseansáith	seansáith	Noun:Fem:Com:Sg:DefArt
tseansálaí	seansálaí	Noun:Masc:Gen:Sg:DefArt
tseansúlacht	seansúlacht	Noun:Fem:Com:Sg:DefArt
tseanscoláire	seanscoláire	Noun:Masc:Gen:Sg:DefArt
tseanscéalaí	seanscéalaí	Noun:Masc:Gen:Sg:DefArt
tseanscéil	seanscéal	Noun:Masc:Gen:Sg:DefArt
tseans	seans	Noun:Masc:Gen:Sg:DefArt
tseantáin	seantán	Noun:Masc:Gen:Sg:DefArt
tseantóra	seantóir	Noun:Masc:Gen:Sg:DefArt
tseantúing	seantúng	Noun:Masc:Gen:Sg:DefArt
tseanveist	seanveist	Noun:Fem:Com:Sg:DefArt
tsearabainc	searabanc	Noun:Masc:Gen:Sg:DefArt
tsearacháin	searachán	Noun:Masc:Gen:Sg:DefArt
tsearantamaim	searantamam	Noun:Masc:Gen:Sg:DefArt
tsearbh-bhiolair	searbh-bhiolar	Noun:Masc:Gen:Sg:DefArt
tsearbhais	searbhas	Noun:Masc:Gen:Sg:DefArt
tsearbháin	searbhán	Noun:Masc:Gen:Sg:DefArt
tsearbhóg	searbhóg	Noun:Fem:Com:Sg:DefArt
tsearbhónta	searbhónta	Noun:Masc:Gen:Sg:DefArt
tsearbhaithe	searbhú	Noun:Masc:Gen:Sg:DefArt
tsearcóg	searcóg	Noun:Fem:Com:Sg:DefArt
tsearc	searc	Noun:Fem:Com:Sg:DefArt
tseargánaigh	seargánach	Noun:Masc:Gen:Sg:DefArt
tseargáin	seargán	Noun:Masc:Gen:Sg:DefArt
tseargthacht	seargthacht	Noun:Fem:Com:Sg:DefArt
tsearmanais	searmanas	Noun:Masc:Gen:Sg:DefArt
tsearraigh	searrach	Noun:Masc:Gen:Sg:DefArt
tsearróg	searróg	Noun:Fem:Com:Sg:DefArt
tsearrtha	searradh	Noun:Masc:Gen:Sg:DefArt
tsearr	searr	Noun:Fem:Com:Sg:DefArt
tseasaireacht	seasaireacht	Noun:Fem:Com:Sg:DefArt
tseasamain	seasaman	Noun:Masc:Gen:Sg:DefArt
tseasaimh	seasamh	Noun:Masc:Gen:Sg:DefArt
tseascaireacht	seascaireacht	Noun:Fem:Com:Sg:DefArt
tseascacháin	seascachán	Noun:Masc:Gen:Sg:DefArt
tseascacht	seascacht	Noun:Fem:Com:Sg:DefArt
tseascach	seascach	Noun:Fem:Com:Sg:DefArt
tseascadú	seascadú	Noun:Masc:Gen:Sg:DefArt
tseascainn	seascann	Noun:Masc:Gen:Sg:DefArt
tseascad	seasca	Noun:Masc:Gen:Sg:DefArt
tseascfhéir	seascfhéar	Noun:Masc:Gen:Sg:DefArt
tseasclaigh	seasclach	Noun:Masc:Gen:Sg:DefArt
tseascra	seascra	Noun:Masc:Gen:Sg:DefArt
tseasmain	seasmain	Noun:Fem:Com:Sg:DefArt
tseasmhacht	seasmhacht	Noun:Fem:Com:Sg:DefArt
tseaspair	seaspar	Noun:Masc:Gen:Sg:DefArt
tseastáin	seastán	Noun:Masc:Gen:Sg:DefArt
tseasa	seas	Noun:Masc:Gen:Sg:DefArt
tseataigh	seatach	Noun:Masc:Gen:Sg:DefArt
tseathrais	seathras	Noun:Masc:Gen:Sg:DefArt
tseatnaí	seatnaí	Noun:Masc:Gen:Sg:DefArt
tsea	sea	Noun:Masc:Gen:Sg:DefArt
tseibinigh	seibineach	Noun:Masc:Gen:Sg:DefArt
tseibhírín	seibhírín	Noun:Masc:Gen:Sg:DefArt
tseiceadóireacht	seiceadóireacht	Noun:Fem:Com:Sg:DefArt
tseiceadóra	seiceadóir	Noun:Masc:Gen:Sg:DefArt
tseiceamair	seiceamar	Noun:Masc:Gen:Sg:DefArt
tseicear	seicear	Noun:Masc:Gen:Sg:DefArt
tseicimín	seicimín	Noun:Masc:Gen:Sg:DefArt
tseicin	seicin	Noun:Fem:Com:Sg:DefArt
tseicire	seicire	Noun:Masc:Gen:Sg:DefArt
tseicitín	seicitín	Noun:Masc:Gen:Sg:DefArt
tseichimh	seicheamh	Noun:Masc:Gen:Sg:DefArt
tseicleabhair	seicleabhar	Noun:Masc:Gen:Sg:DefArt
tseicréitin	seicréitin	Noun:Fem:Com:Sg:DefArt
tseicteachais	seicteachas	Noun:Masc:Gen:Sg:DefArt
tseict	seict	Noun:Fem:Com:Sg:DefArt
tseicil	seiceal	Noun:Masc:Gen:Sg:DefArt
tseicint	seiceant	Noun:Masc:Gen:Sg:DefArt
tseic	seic	Noun:Masc:Gen:Sg:DefArt
tseid	seid	Noun:Fem:Com:Sg:DefArt
tseifide	seifide	Noun:Masc:Gen:Sg:DefArt
tseifteora	seifteoir	Noun:Masc:Gen:Sg:DefArt
tseiftiúlacht	seiftiúlacht	Noun:Fem:Com:Sg:DefArt
tseiftithe	seiftiú	Noun:Masc:Gen:Sg:DefArt
tseift	seift	Noun:Fem:Com:Sg:DefArt
tseileaic	seileaic	Noun:Fem:Com:Sg:DefArt
tseileadáin	seileadán	Noun:Masc:Gen:Sg:DefArt
tseileagair	seileagar	Noun:Masc:Gen:Sg:DefArt
tseileog	seileog	Noun:Fem:Com:Sg:DefArt
tseileáin	seileán	Noun:Masc:Gen:Sg:DefArt
tseile	seile	Noun:Fem:Com:Sg:DefArt
tseilide	seilide	Noun:Masc:Gen:Sg:DefArt
tseilinís	seilinís	Noun:Fem:Com:Sg:DefArt
tseilithe	seiliú	Noun:Masc:Gen:Sg:DefArt
tseiléineagrafaíocht	seiléineagrafaíocht	Noun:Fem:Com:Sg:DefArt
tseiléiniam	seiléiniam	Noun:Masc:Gen:Sg:DefArt
tseiléinít	seiléinít	Noun:Fem:Com:Sg:DefArt
tseilbh	seilbh	Noun:Fem:Com:Sg:DefArt
tseilf	seilf	Noun:Fem:Com:Sg:DefArt
tseilg	seilg	Noun:Fem:Com:Sg:DefArt
tseilmideáil	seilmideáil	Noun:Fem:Com:Sg:DefArt
tseilmideálaí	seilmideálaí	Noun:Masc:Gen:Sg:DefArt
tseilp	seilp	Noun:Fem:Com:Sg:DefArt
tseilt	seilt	Noun:Fem:Com:Sg:DefArt
tseimide	seimide	Noun:Masc:Gen:Sg:DefArt
tseimilín	seimilín	Noun:Masc:Gen:Sg:DefArt
tseimineáir	seimineár	Noun:Masc:Gen:Sg:DefArt
tseineafóibe	seineafóibe	Noun:Fem:Com:Sg:DefArt
tseineafóbaigh	seineafóbach	Noun:Masc:Gen:Sg:DefArt
tseinge	seinge	Noun:Fem:Com:Sg:DefArt
tseinm	seinm	Noun:Fem:Com:Sg:DefArt
tseinnteora	seinnteoir	Noun:Masc:Gen:Sg:DefArt
tseintimint	seintimint	Noun:Fem:Com:Sg:DefArt
tseipléireacht	seipléireacht	Noun:Fem:Com:Sg:DefArt
tseipléara	seipléir	Noun:Masc:Gen:Sg:DefArt
tseipsis	seipseas	Noun:Masc:Gen:Sg:DefArt
tseipticéime	seipticéime	Noun:Fem:Com:Sg:DefArt
tseipil	seipeal	Noun:Masc:Gen:Sg:DefArt
tseiriúit	seiriút	Noun:Masc:Gen:Sg:DefArt
tseiriceáin	seiriceán	Noun:Masc:Gen:Sg:DefArt
tseiric	seiric	Noun:Fem:Com:Sg:DefArt
tseiris	seiris	Noun:Fem:Com:Sg:DefArt
tseirín	seirín	Noun:Masc:Gen:Sg:DefArt
tseirbit	seirbit	Noun:Fem:Com:Sg:DefArt
tseirbheamótair	seirbheamótar	Noun:Masc:Gen:Sg:DefArt
tseirbheáil	seirbheáil	Noun:Fem:Com:Sg:DefArt
tseirbheálaí	seirbheálaí	Noun:Masc:Gen:Sg:DefArt
tseirbhe	seirbhe	Noun:Fem:Com:Sg:DefArt
tseirbhísigh	seirbhíseach	Noun:Masc:Gen:Sg:DefArt
tseirbhís	seirbhís	Noun:Fem:Com:Sg:DefArt
tseircín	seircín	Noun:Masc:Gen:Sg:DefArt
tseircín	seircín	Noun:Fem:Com:Sg:DefArt
tseirdín	seirdín	Noun:Masc:Gen:Sg:DefArt
tseirfeachais	seirfeachas	Noun:Masc:Gen:Sg:DefArt
tseirfigh	seirfeach	Noun:Masc:Gen:Sg:DefArt
tseirfin	seirfean	Noun:Masc:Gen:Sg:DefArt
tseirge	seirge	Noun:Fem:Com:Sg:DefArt
tseirglí	seirglí	Noun:Masc:Gen:Sg:DefArt
tseirgthigh	seirgtheach	Noun:Masc:Gen:Sg:DefArt
tseirseanaigh	seirseanach	Noun:Masc:Gen:Sg:DefArt
tseirt	seirt	Noun:Fem:Com:Sg:DefArt
tseir	seir	Noun:Fem:Com:Sg:DefArt
tseiseacht	seiseacht	Noun:Fem:Com:Sg:DefArt
tseiseamháin	seiseamhán	Noun:Masc:Gen:Sg:DefArt
tseise	seise	Noun:Masc:Gen:Sg:DefArt
tseisiúin	seisiún	Noun:Masc:Gen:Sg:DefArt
tseisire	seisire	Noun:Masc:Gen:Sg:DefArt
tseisígh	seisíoch	Noun:Masc:Gen:Sg:DefArt
tseisce-ocsaíd	seisce-ocsaíd	Noun:Fem:Com:Sg:DefArt
tseisce	seisce	Noun:Fem:Com:Sg:DefArt
tseisc	seisc	Noun:Fem:Com:Sg:DefArt
tseismeagrafaíocht	seismeagrafaíocht	Noun:Fem:Com:Sg:DefArt
tseismeagrafaí	seismeagrafaí	Noun:Masc:Gen:Sg:DefArt
tseismeagraif	seismeagraf	Noun:Masc:Gen:Sg:DefArt
tseismeanastacht	seismeanastacht	Noun:Fem:Com:Sg:DefArt
tseismeolaíocht	seismeolaíocht	Noun:Fem:Com:Sg:DefArt
tseismeolaí	seismeolaí	Noun:Masc:Gen:Sg:DefArt
tseismiméadair	seismiméadar	Noun:Masc:Gen:Sg:DefArt
tseisreach	seisreach	Noun:Fem:Com:Sg:DefArt
tseisréid	seisréad	Noun:Masc:Gen:Sg:DefArt
tseist	seist	Noun:Fem:Com:Sg:DefArt
tseisigh	seiseach	Noun:Masc:Gen:Sg:DefArt
tseisir	seisear	Noun:Masc:Gen:Sg:DefArt
tseitgháire	seitgháire	Noun:Masc:Gen:Sg:DefArt
tseitheadóra	seitheadóir	Noun:Masc:Gen:Sg:DefArt
tseithe	seithe	Noun:Fem:Com:Sg:DefArt
tseithide	seithide	Noun:Masc:Gen:Sg:DefArt
tseithimh	seitheamh	Noun:Masc:Gen:Sg:DefArt
tseitreach	seitreach	Noun:Fem:Com:Sg:DefArt
tseitríl	seitríl	Noun:Fem:Com:Sg:DefArt
tseitse	seitse	Noun:Fem:Com:Sg:DefArt
tseit	seit	Noun:Masc:Gen:Sg:DefArt
tseoidire	seoidire	Noun:Masc:Gen:Sg:DefArt
tseoid	seoid	Noun:Fem:Com:Sg:DefArt
tseoilít	seoilít	Noun:Fem:Com:Sg:DefArt
tseoinínteacht	seoinínteacht	Noun:Fem:Com:Sg:DefArt
tseoinín	seoinín	Noun:Masc:Gen:Sg:DefArt
tseoirséid	seoirséad	Noun:Masc:Gen:Sg:DefArt
tseoithín	seoithín	Noun:Masc:Gen:Sg:DefArt
tseobhaineachais	seobhaineachas	Noun:Masc:Gen:Sg:DefArt
tseochruais	seochruas	Noun:Masc:Gen:Sg:DefArt
tseoch	seoch	Noun:Masc:Gen:Sg:DefArt
tseodóireacht	seodóireacht	Noun:Fem:Com:Sg:DefArt
tseodóra	seodóir	Noun:Masc:Gen:Sg:DefArt
tseodra	seodra	Noun:Masc:Gen:Sg:DefArt
tseolaí	seolaí	Noun:Masc:Gen:Sg:DefArt
tseoladáin	seoladán	Noun:Masc:Gen:Sg:DefArt
tseoladóireacht	seoladóireacht	Noun:Fem:Com:Sg:DefArt
tseoladóra	seoladóir	Noun:Masc:Gen:Sg:DefArt
tseoláin	seolán	Noun:Masc:Gen:Sg:DefArt
tseolbhealaigh	seolbhealach	Noun:Masc:Gen:Sg:DefArt
tseolbhrait	seolbhrat	Noun:Masc:Gen:Sg:DefArt
tseolchrainn	seolchrann	Noun:Masc:Gen:Sg:DefArt
tseolfheadáin	seolfheadán	Noun:Masc:Gen:Sg:DefArt
tseolphíopa	seolphíopa	Noun:Masc:Gen:Sg:DefArt
tseoltacht	seoltacht	Noun:Fem:Com:Sg:DefArt
tseoltais	seoltas	Noun:Masc:Gen:Sg:DefArt
tseoltáin	seoltán	Noun:Masc:Gen:Sg:DefArt
tseoltóireacht	seoltóireacht	Noun:Fem:Com:Sg:DefArt
tseoltóra	seoltóir	Noun:Masc:Gen:Sg:DefArt
tseoltrioc	seoltrioc	Noun:Masc:Gen:Sg:DefArt
tseolta	seoladh	Noun:Masc:Gen:Sg:DefArt
tseomairlín	seomairlín	Noun:Masc:Gen:Sg:DefArt
tseomradóra	seomradóir	Noun:Masc:Gen:Sg:DefArt
tseomra	seomra	Noun:Masc:Gen:Sg:DefArt
tseoraíl	seoraíl	Noun:Fem:Com:Sg:DefArt
tseoráil	seoráil	Noun:Fem:Com:Sg:DefArt
tseorálaí	seorálaí	Noun:Masc:Gen:Sg:DefArt
tseordáin	seordán	Noun:Masc:Gen:Sg:DefArt
tseornaiseoim	seornaiseom	Noun:Masc:Gen:Sg:DefArt
tseoil	seol	Noun:Masc:Gen:Sg:DefArt
tseápáil	seápáil	Noun:Fem:Com:Sg:DefArt
tseáp	seáp	Noun:Masc:Gen:Sg:DefArt
tseártrúis	seártrús	Noun:Masc:Gen:Sg:DefArt
tseáil	seál	Noun:Masc:Gen:Sg:DefArt
tseó	seó	Noun:Masc:Gen:Sg:DefArt
tsiabhránacht	siabhránacht	Noun:Fem:Com:Sg:DefArt
tsiabhránaigh	siabhránach	Noun:Masc:Gen:Sg:DefArt
tsiabhráin	siabhrán	Noun:Masc:Gen:Sg:DefArt
tsiamsa	siamsa	Noun:Masc:Gen:Sg:DefArt
tsianaíl	sianaíl	Noun:Fem:Com:Sg:DefArt
tsianaí	sianaí	Noun:Masc:Gen:Sg:DefArt
tsianáin	sianán	Noun:Masc:Gen:Sg:DefArt
tsiansaigh	siansach	Noun:Masc:Gen:Sg:DefArt
tsiansa	siansa	Noun:Masc:Gen:Sg:DefArt
tsiansáin	siansán	Noun:Masc:Gen:Sg:DefArt
tsian	sian	Noun:Fem:Com:Sg:DefArt
tsiail	sial	Noun:Masc:Gen:Sg:DefArt
tsiobailit	siobaileat	Noun:Masc:Gen:Sg:DefArt
tsiobarnach	siobarnach	Noun:Fem:Com:Sg:DefArt
tsiobáil	siobáil	Noun:Fem:Com:Sg:DefArt
tsiobráil	siobráil	Noun:Fem:Com:Sg:DefArt
tsioc-cheo	sioc-cheo	Noun:Masc:Gen:Sg:DefArt
tsiocaire	siocaire	Noun:Masc:Gen:Sg:DefArt
tsiocair	siocair	Noun:Fem:Com:Sg:DefArt
tsiocadaíl	siocadaíl	Noun:Fem:Com:Sg:DefArt
tsiocáin	siocán	Noun:Masc:Gen:Sg:DefArt
tsiocúlacht	siocúlacht	Noun:Fem:Com:Sg:DefArt
tsiocdhó	siocdhó	Noun:Masc:Gen:Sg:DefArt
tsiodail	siodal	Noun:Masc:Gen:Sg:DefArt
tsiodfhéachaint	siodfhéachaint	Noun:Fem:Com:Sg:DefArt
tsiofóin	siofón	Noun:Masc:Gen:Sg:DefArt
tsiogairlín	siogairlín	Noun:Masc:Gen:Sg:DefArt
tsiogarlaigh	siogarlach	Noun:Masc:Gen:Sg:DefArt
tsiogarla	siogarla	Noun:Masc:Gen:Sg:DefArt
tsiogóma	siogóma	Noun:Masc:Gen:Sg:DefArt
tsiogóit	siogót	Noun:Masc:Gen:Sg:DefArt
tsiogma	siogma	Noun:Masc:Gen:Sg:DefArt
tsiolgaireacht	siolgaireacht	Noun:Fem:Com:Sg:DefArt
tsiolgaire	siolgaire	Noun:Masc:Gen:Sg:DefArt
tsiollaireacht	siollaireacht	Noun:Fem:Com:Sg:DefArt
tsiollaire	siollaire	Noun:Masc:Gen:Sg:DefArt
tsiollabais	siollabas	Noun:Masc:Gen:Sg:DefArt
tsiollaigh	siollach	Noun:Masc:Gen:Sg:DefArt
tsiolla	siolla	Noun:Masc:Gen:Sg:DefArt
tsiollántacht	siollántacht	Noun:Fem:Com:Sg:DefArt
tsiollógacht	siollógacht	Noun:Fem:Com:Sg:DefArt
tsiollóg	siollóg	Noun:Fem:Com:Sg:DefArt
tsiollfarnach	siollfarnach	Noun:Fem:Com:Sg:DefArt
tsiolpaireacht	siolpaireacht	Noun:Fem:Com:Sg:DefArt
tsiolpaire	siolpaire	Noun:Masc:Gen:Sg:DefArt
tsiolpaigh	siolpach	Noun:Masc:Gen:Sg:DefArt
tsiolpa	siolpa	Noun:Masc:Gen:Sg:DefArt
tsiolracháin	siolrachán	Noun:Masc:Gen:Sg:DefArt
tsiolta	siolta	Noun:Masc:Gen:Sg:DefArt
tsioma	sioma	Noun:Masc:Gen:Sg:DefArt
tsiomóid	siomóid	Noun:Fem:Com:Sg:DefArt
tsiomúin	siomún	Noun:Masc:Gen:Sg:DefArt
tsiombail	siombail	Noun:Fem:Com:Sg:DefArt
tsiombalaí	siombalaí	Noun:Masc:Gen:Sg:DefArt
tsiombalachais	siombalachas	Noun:Masc:Gen:Sg:DefArt
tsiombalaithe	siombalú	Noun:Masc:Gen:Sg:DefArt
tsiombóis	siombóis	Noun:Fem:Com:Sg:DefArt
tsiompóisiam	siompóisiam	Noun:Masc:Gen:Sg:DefArt
tsionagóg	sionagóg	Noun:Fem:Com:Sg:DefArt
tsionaglaigh	sionaglach	Noun:Masc:Gen:Sg:DefArt
tsionapsais	sionapsais	Noun:Fem:Com:Sg:DefArt
tsionapsa	sionapsa	Noun:Masc:Gen:Sg:DefArt
tsionaid	sionad	Noun:Masc:Gen:Sg:DefArt
tsionóibhia	sionóibhia	Noun:Fem:Com:Sg:DefArt
tsionóibhítis	sionóibhíteas	Noun:Masc:Gen:Sg:DefArt
tsioncóipis	sioncóipis	Noun:Fem:Com:Sg:DefArt
tsioncóipithe	sioncóipiú	Noun:Masc:Gen:Sg:DefArt
tsioncrónacht	sioncrónacht	Noun:Fem:Com:Sg:DefArt
tsioncrónaithe	sioncrónú	Noun:Masc:Gen:Sg:DefArt
tsiondróim	siondróm	Noun:Masc:Gen:Sg:DefArt
tsiongamacht	siongamacht	Noun:Fem:Com:Sg:DefArt
tsionnachúlacht	sionnachúlacht	Noun:Fem:Com:Sg:DefArt
tsionnaigh	sionnach	Noun:Masc:Gen:Sg:DefArt
tsionnaidh	sionnadh	Noun:Masc:Gen:Sg:DefArt
tsionsa	sionsa	Noun:Masc:Gen:Sg:DefArt
tsionsáil	sionsáil	Noun:Fem:Com:Sg:DefArt
tsions	sions	Noun:Masc:Gen:Sg:DefArt
tsiopach	siopach	Noun:Fem:Com:Sg:DefArt
tsiopadóireacht	siopadóireacht	Noun:Fem:Com:Sg:DefArt
tsiopadóra	siopadóir	Noun:Masc:Gen:Sg:DefArt
tsiopa	siopa	Noun:Masc:Gen:Sg:DefArt
tsioplais	sioplais	Noun:Fem:Com:Sg:DefArt
tsioráif	sioráf	Noun:Masc:Gen:Sg:DefArt
tsiorcóiniam	siorcóiniam	Noun:Masc:Gen:Sg:DefArt
tsiorcóin	siorcón	Noun:Masc:Gen:Sg:DefArt
tsiorca	siorc	Noun:Masc:Gen:Sg:DefArt
tsiorraidh	siorradh	Noun:Masc:Gen:Sg:DefArt
tsiorra	siorra	Noun:Masc:Gen:Sg:DefArt
tsiortaitheora	siortaitheoir	Noun:Masc:Gen:Sg:DefArt
tsiortóg	siortóg	Noun:Fem:Com:Sg:DefArt
tsior	sior	Noun:Masc:Gen:Sg:DefArt
tsiosaire	siosaire	Noun:Masc:Gen:Sg:DefArt
tsiosarnach	siosarnach	Noun:Fem:Com:Sg:DefArt
tsiosaigh	siosach	Noun:Masc:Gen:Sg:DefArt
tsiosail	siosal	Noun:Masc:Gen:Sg:DefArt
tsiosa	siosa	Noun:Masc:Gen:Sg:DefArt
tsiosóg	siosóg	Noun:Fem:Com:Sg:DefArt
tsiosúir	siosúr	Noun:Masc:Gen:Sg:DefArt
tsiosctha	sioscadh	Noun:Masc:Gen:Sg:DefArt
tsiosmaid	siosmaid	Noun:Fem:Com:Sg:DefArt
tsiosmaigh	siosmach	Noun:Masc:Gen:Sg:DefArt
tsiosma	siosma	Noun:Masc:Gen:Sg:DefArt
tsiostalóra	siostalóir	Noun:Masc:Gen:Sg:DefArt
tsiostail	siostal	Noun:Masc:Gen:Sg:DefArt
tsiosta	siosta	Noun:Masc:Gen:Sg:DefArt
tsiostóil	siostól	Noun:Masc:Gen:Sg:DefArt
tsiotaíocht	siotaíocht	Noun:Fem:Com:Sg:DefArt
tsiotaíl	siotaíl	Noun:Fem:Com:Sg:DefArt
tsiotalaigh	siotalach	Noun:Masc:Gen:Sg:DefArt
tsiotair	siotar	Noun:Masc:Gen:Sg:DefArt
tsiota	siota	Noun:Masc:Gen:Sg:DefArt
tsiotóg	siotóg	Noun:Fem:Com:Sg:DefArt
tsiota	siot	Noun:Masc:Gen:Sg:DefArt
tsián	sián	Noun:Masc:Gen:Sg:DefArt
tsióg	sióg	Noun:Fem:Com:Sg:DefArt
tsiúicríd	siúicríd	Noun:Fem:Com:Sg:DefArt
tsiúicrín	siúicrín	Noun:Masc:Gen:Sg:DefArt
tsiúinéireacht	siúinéireacht	Noun:Fem:Com:Sg:DefArt
tsiúinéara	siúinéir	Noun:Masc:Gen:Sg:DefArt
tsiúite	siúite	Noun:Masc:Gen:Sg:DefArt
tsiúit	siúit	Noun:Fem:Com:Sg:DefArt
tsiúcramhéadair	siúcramhéadar	Noun:Masc:Gen:Sg:DefArt
tsiúcra	siúcra	Noun:Masc:Gen:Sg:DefArt
tsiúcróis	siúcrós	Noun:Masc:Gen:Sg:DefArt
tsiúcrúlacht	siúcrúlacht	Noun:Fem:Com:Sg:DefArt
tsiúlóidí	siúlóidí	Noun:Masc:Gen:Sg:DefArt
tsiúlóid	siúlóid	Noun:Fem:Com:Sg:DefArt
tsiúlóra	siúlóir	Noun:Masc:Gen:Sg:DefArt
tsiúnta	siúnta	Noun:Masc:Gen:Sg:DefArt
tsiúntóra	siúntóir	Noun:Masc:Gen:Sg:DefArt
tsiúntchiorcaid	siúntchiorcad	Noun:Masc:Gen:Sg:DefArt
tsiúnta	siúnt	Noun:Masc:Gen:Sg:DefArt
tsiúráilteacht	siúráilteacht	Noun:Fem:Com:Sg:DefArt
tsiúráil	siúráil	Noun:Fem:Com:Sg:DefArt
tsiúrsáin	siúrsán	Noun:Masc:Gen:Sg:DefArt
tsiúr	siúr	Noun:Fem:Com:Sg:DefArt
tsiústráil	siústráil	Noun:Fem:Com:Sg:DefArt
tsiúil	siúl	Noun:Masc:Gen:Sg:DefArt
tsibiléireacht	sibiléireacht	Noun:Fem:Com:Sg:DefArt
tsibille	sibille	Noun:Fem:Com:Sg:DefArt
tsibiritigh	sibiriteach	Noun:Masc:Gen:Sg:DefArt
tsibheanraidh	sibheanradh	Noun:Masc:Gen:Sg:DefArt
tsibhialtacht	sibhialtacht	Noun:Fem:Com:Sg:DefArt
tsibhialtaigh	sibhialtach	Noun:Masc:Gen:Sg:DefArt
tsibhialtóra	sibhialtóir	Noun:Masc:Gen:Sg:DefArt
tsibhéid	sibhéid	Noun:Fem:Com:Sg:DefArt
tsiceafantaíocht	siceafantaíocht	Noun:Fem:Com:Sg:DefArt
tsiceafaint	siceafant	Noun:Masc:Gen:Sg:DefArt
tsicín	sicín	Noun:Masc:Gen:Sg:DefArt
tsicbhainne	sicbhainne	Noun:Masc:Gen:Sg:DefArt
tsicfhéir	sicfhéar	Noun:Masc:Gen:Sg:DefArt
tsicreo	sicreo	Noun:Masc:Gen:Sg:DefArt
tsicréideacht	sicréideacht	Noun:Fem:Com:Sg:DefArt
tsicréid	sicréid	Noun:Fem:Com:Sg:DefArt
tsifearnaíl	sifearnaíl	Noun:Fem:Com:Sg:DefArt
tsifilis	sifilis	Noun:Fem:Com:Sg:DefArt
tsifil	sifil	Noun:Fem:Com:Sg:DefArt
tsifín	sifín	Noun:Masc:Gen:Sg:DefArt
tsifleáil	sifleáil	Noun:Fem:Com:Sg:DefArt
tsigeaspóir	sigeaspór	Noun:Masc:Gen:Sg:DefArt
tsigir	sigir	Noun:Fem:Com:Sg:DefArt
tsil-leagain	sil-leagan	Noun:Masc:Gen:Sg:DefArt
tsil-luchtaire	sil-luchtaire	Noun:Masc:Gen:Sg:DefArt
tsileacain	sileacan	Noun:Masc:Gen:Sg:DefArt
tsileacáit	sileacáit	Noun:Fem:Com:Sg:DefArt
tsileacóin	sileacón	Noun:Masc:Gen:Sg:DefArt
tsileog	sileog	Noun:Fem:Com:Sg:DefArt
tsileáin	sileán	Noun:Masc:Gen:Sg:DefArt
tsilice	silice	Noun:Fem:Com:Sg:DefArt
tsiléigeacht	siléigeacht	Noun:Fem:Com:Sg:DefArt
tsiléig	siléig	Noun:Fem:Com:Sg:DefArt
tsiléine	siléine	Noun:Fem:Com:Sg:DefArt
tsiléipse	siléipse	Noun:Fem:Com:Sg:DefArt
tsiléireacht	siléireacht	Noun:Fem:Com:Sg:DefArt
tsiléir	siléar	Noun:Masc:Gen:Sg:DefArt
tsilíneacht	silíneacht	Noun:Fem:Com:Sg:DefArt
tsilín	silín	Noun:Masc:Gen:Sg:DefArt
tsillte	silleadh	Noun:Masc:Gen:Sg:DefArt
tsilteacht	silteacht	Noun:Fem:Com:Sg:DefArt
tsilteoireacht	silteoireacht	Noun:Fem:Com:Sg:DefArt
tsilteora	silteoir	Noun:Masc:Gen:Sg:DefArt
tsilteánaigh	silteánach	Noun:Masc:Gen:Sg:DefArt
tsilteáin	silteán	Noun:Masc:Gen:Sg:DefArt
tsiltin	siltean	Noun:Masc:Gen:Sg:DefArt
tsilic	sileac	Noun:Masc:Gen:Sg:DefArt
tsilidh	sileadh	Noun:Masc:Gen:Sg:DefArt
tsil	sil	Noun:Fem:Com:Sg:DefArt
tsimeatáir	simeatár	Noun:Masc:Gen:Sg:DefArt
tsimiaich	simiach	Noun:Masc:Gen:Sg:DefArt
tsiméadracht	siméadracht	Noun:Fem:Com:Sg:DefArt
tsimléir	simléar	Noun:Masc:Gen:Sg:DefArt
tsimlidh	simleadh	Noun:Masc:Gen:Sg:DefArt
tsimpeansaí	simpeansaí	Noun:Masc:Gen:Sg:DefArt
tsimpleachais	simpleachas	Noun:Masc:Gen:Sg:DefArt
tsimpleoireacht	simpleoireacht	Noun:Fem:Com:Sg:DefArt
tsimpleora	simpleoir	Noun:Masc:Gen:Sg:DefArt
tsimpliúcháin	simpliúchán	Noun:Masc:Gen:Sg:DefArt
tsimplithe	simpliú	Noun:Masc:Gen:Sg:DefArt
tsimplíocht	simplíocht	Noun:Fem:Com:Sg:DefArt
tsin-seanathar	sin-seanathair	Noun:Masc:Gen:Sg:DefArt
tsin-seanmháthair	sin-seanmháthair	Noun:Fem:Com:Sg:DefArt
tsineach	sineach	Noun:Fem:Com:Sg:DefArt
tsineirgid	sineirgid	Noun:Fem:Com:Sg:DefArt
tsineirgíocht	sineirgíocht	Noun:Fem:Com:Sg:DefArt
tsineáin	sineán	Noun:Masc:Gen:Sg:DefArt
tsinechreatha	sinechrith	Noun:Masc:Gen:Sg:DefArt
tsine	sine	Noun:Fem:Com:Sg:DefArt
tsinéidín	sinéidín	Noun:Masc:Gen:Sg:DefArt
tsinéid	sinéid	Noun:Fem:Com:Sg:DefArt
tsinéiréis	sinéiréis	Noun:Fem:Com:Sg:DefArt
tsinc-chumaisc	sinc-chumasc	Noun:Masc:Gen:Sg:DefArt
tsinceagrafaíocht	sinceagrafaíocht	Noun:Fem:Com:Sg:DefArt
tsinceagraif	sinceagraf	Noun:Masc:Gen:Sg:DefArt
tsinciarainn	sinciarann	Noun:Masc:Gen:Sg:DefArt
tsincithe	sinciú	Noun:Masc:Gen:Sg:DefArt
tsincreatróin	sincreatrón	Noun:Masc:Gen:Sg:DefArt
tsincréataí	sincréataí	Noun:Masc:Gen:Sg:DefArt
tsincréatachais	sincréatachas	Noun:Masc:Gen:Sg:DefArt
tsinc	sinc	Noun:Fem:Com:Sg:DefArt
tsindeacáit	sindeacáit	Noun:Fem:Com:Sg:DefArt
tsingilteacht	singilteacht	Noun:Fem:Com:Sg:DefArt
tsingleáil	singleáil	Noun:Fem:Com:Sg:DefArt
tsingléid	singléad	Noun:Masc:Gen:Sg:DefArt
tsinsearacht	sinsearacht	Noun:Fem:Com:Sg:DefArt
tsinsearaigh	sinsearach	Noun:Masc:Gen:Sg:DefArt
tsinsile	sinsile	Noun:Fem:Com:Sg:DefArt
tsinséir	sinséar	Noun:Masc:Gen:Sg:DefArt
tsinsir	sinsear	Noun:Masc:Gen:Sg:DefArt
tsintéis	sintéis	Noun:Fem:Com:Sg:DefArt
tsintéir	sintéar	Noun:Masc:Gen:Sg:DefArt
tsipiléireacht	sipiléireacht	Noun:Fem:Com:Sg:DefArt
tsipiléara	sipiléir	Noun:Masc:Gen:Sg:DefArt
tsipdhúntóra	sipdhúntóir	Noun:Masc:Gen:Sg:DefArt
tsip	sip	Noun:Fem:Com:Sg:DefArt
tsireacó	sireacó	Noun:Masc:Gen:Sg:DefArt
tsiride	siride	Noun:Masc:Gen:Sg:DefArt
tsiringe	siringe	Noun:Fem:Com:Sg:DefArt
tsirriamacht	sirriamacht	Noun:Fem:Com:Sg:DefArt
tsirriam	sirriam	Noun:Masc:Gen:Sg:DefArt
tsirtheoireacht	sirtheoireacht	Noun:Fem:Com:Sg:DefArt
tsirtheora	sirtheoir	Noun:Masc:Gen:Sg:DefArt
tsisiúb	sisiúb	Noun:Fem:Com:Sg:DefArt
tsisige	sisige	Noun:Fem:Com:Sg:DefArt
tsisile	sisile	Noun:Fem:Com:Sg:DefArt
tsiséil	siséal	Noun:Masc:Gen:Sg:DefArt
tsiscín	siscín	Noun:Masc:Gen:Sg:DefArt
tsistéil	sistéal	Noun:Masc:Gen:Sg:DefArt
tsisil	siseal	Noun:Masc:Gen:Sg:DefArt
tsiteacóis	siteacóis	Noun:Fem:Com:Sg:DefArt
tsithiúlacht	sithiúlacht	Noun:Fem:Com:Sg:DefArt
tsithire	sithire	Noun:Masc:Gen:Sg:DefArt
tsithbhe	sithbhe	Noun:Masc:Gen:Sg:DefArt
tsithbháirc	sithbhárc	Noun:Masc:Gen:Sg:DefArt
tsithbhladha	sithbhladh	Noun:Masc:Gen:Sg:DefArt
tsithidh	sitheadh	Noun:Masc:Gen:Sg:DefArt
tsithig	sitheag	Noun:Masc:Gen:Sg:DefArt
tsith	sith	Noun:Fem:Com:Sg:DefArt
tseaca	sioc	Noun:Masc:Gen:Sg:DefArt
tso-ionramháilteacht	so-ionramháilteacht	Noun:Fem:Com:Sg:DefArt
tso-bhlastacht	so-bhlastacht	Noun:Fem:Com:Sg:DefArt
tso-ghabháltacht	so-ghabháltacht	Noun:Fem:Com:Sg:DefArt
tso-ghalaitheacht	so-ghalaitheacht	Noun:Fem:Com:Sg:DefArt
tso-lastacht	so-lastacht	Noun:Fem:Com:Sg:DefArt
tso-mharfacht	so-mharfacht	Noun:Fem:Com:Sg:DefArt
tsoibealtacht	soibealtacht	Noun:Fem:Com:Sg:DefArt
tsoibealtáin	soibealtán	Noun:Masc:Gen:Sg:DefArt
tsoicind	soicind	Noun:Masc:Gen:Sg:DefArt
tsoicéid	soicéad	Noun:Masc:Gen:Sg:DefArt
tsoichill	soicheall	Noun:Masc:Gen:Sg:DefArt
tsoidéalacht	soidéalacht	Noun:Fem:Com:Sg:DefArt
tsoidéalaigh	soidéalach	Noun:Masc:Gen:Sg:DefArt
tsoighe	soighe	Noun:Masc:Gen:Sg:DefArt
tsoilire	soilire	Noun:Masc:Gen:Sg:DefArt
tsoiléireacht	soiléireacht	Noun:Fem:Com:Sg:DefArt
tsoiléirithe	soiléiriú	Noun:Masc:Gen:Sg:DefArt
tsoiléirse	soiléirse	Noun:Fem:Com:Sg:DefArt
tsoiléis	soiléas	Noun:Masc:Gen:Sg:DefArt
tsoilís	soilíos	Noun:Masc:Gen:Sg:DefArt
tsoilbhris	soilbhreas	Noun:Masc:Gen:Sg:DefArt
tsoilseacht	soilseacht	Noun:Fem:Com:Sg:DefArt
tsoilseáin	soilseán	Noun:Masc:Gen:Sg:DefArt
tsoilse	soilse	Noun:Fem:Com:Sg:DefArt
tsoilsitheora	soilsitheoir	Noun:Masc:Gen:Sg:DefArt
tsoilsithe	soilsiú	Noun:Masc:Gen:Sg:DefArt
tsoineann	soineann	Noun:Fem:Com:Sg:DefArt
tsoineantacht	soineantacht	Noun:Fem:Com:Sg:DefArt
tsoinéid	soinéad	Noun:Masc:Gen:Sg:DefArt
tsoinneáin	soinneán	Noun:Masc:Gen:Sg:DefArt
tsoipeacháin	soipeachán	Noun:Masc:Gen:Sg:DefArt
tsoipínteacht	soipínteacht	Noun:Fem:Com:Sg:DefArt
tsoipínigh	soipíneach	Noun:Masc:Gen:Sg:DefArt
tsoipín	soipín	Noun:Masc:Gen:Sg:DefArt
tsoiriáis	soiriáis	Noun:Fem:Com:Sg:DefArt
tsoirbéid	soirbéad	Noun:Masc:Gen:Sg:DefArt
tsoirbhíochais	soirbhíochas	Noun:Masc:Gen:Sg:DefArt
tsoirbhígh	soirbhíoch	Noun:Masc:Gen:Sg:DefArt
tsoirbhis	soirbheas	Noun:Masc:Gen:Sg:DefArt
tsoirche	soirche	Noun:Fem:Com:Sg:DefArt
tsoirc	soirc	Noun:Fem:Com:Sg:DefArt
tsoiscéalaíocht	soiscéalaíocht	Noun:Fem:Com:Sg:DefArt
tsoiscéalaí	soiscéalaí	Noun:Masc:Gen:Sg:DefArt
tsoiscéil	soiscéal	Noun:Masc:Gen:Sg:DefArt
tsoithigh	soitheach	Noun:Masc:Gen:Sg:DefArt
tsoith	soith	Noun:Fem:Com:Sg:DefArt
tsobail	sobal	Noun:Masc:Gen:Sg:DefArt
tsobharthain	sobharthan	Noun:Masc:Gen:Sg:DefArt
tsobhristeacht	sobhristeacht	Noun:Fem:Com:Sg:DefArt
tsoblaim	soblam	Noun:Masc:Gen:Sg:DefArt
tsocadáin	socadán	Noun:Masc:Gen:Sg:DefArt
tsocáin	socán	Noun:Masc:Gen:Sg:DefArt
tsocfhréamh	socfhréamh	Noun:Fem:Com:Sg:DefArt
tsochaí	sochaí	Noun:Fem:Com:Sg:DefArt
tsochapataigh	sochapatach	Noun:Masc:Gen:Sg:DefArt
tsochaird	sochard	Noun:Masc:Gen:Sg:DefArt
tsochair	sochar	Noun:Masc:Gen:Sg:DefArt
tsocheolaíocht	socheolaíocht	Noun:Fem:Com:Sg:DefArt
tsocheolaí	socheolaí	Noun:Masc:Gen:Sg:DefArt
tsochorraitheacht	sochorraitheacht	Noun:Fem:Com:Sg:DefArt
tsochlaigh	sochlach	Noun:Masc:Gen:Sg:DefArt
tsochmaíocht	sochmaíocht	Noun:Fem:Com:Sg:DefArt
tsochmáin	sochmán	Noun:Masc:Gen:Sg:DefArt
tsochraidigh	sochraideach	Noun:Masc:Gen:Sg:DefArt
tsochraid	sochraid	Noun:Fem:Com:Sg:DefArt
tsochraíocht	sochraíocht	Noun:Fem:Com:Sg:DefArt
tsochracht	sochracht	Noun:Fem:Com:Sg:DefArt
tsochtóra	sochtóir	Noun:Masc:Gen:Sg:DefArt
tsochtghreille	sochtghreille	Noun:Fem:Com:Sg:DefArt
tsocmhála	socmhála	Noun:Masc:Gen:Sg:DefArt
tsocraitheora	socraitheoir	Noun:Masc:Gen:Sg:DefArt
tsocraíocht	socraíocht	Noun:Fem:Com:Sg:DefArt
tsocracht	socracht	Noun:Fem:Com:Sg:DefArt
tsocrú	socrú	Noun:Masc:Gen:Sg:DefArt
tsodaire	sodaire	Noun:Masc:Gen:Sg:DefArt
tsodamacht	sodamacht	Noun:Fem:Com:Sg:DefArt
tsodamaigh	sodamach	Noun:Masc:Gen:Sg:DefArt
tsodamáin	sodamán	Noun:Masc:Gen:Sg:DefArt
tsodarnaíl	sodarnaíl	Noun:Fem:Com:Sg:DefArt
tsodair	sodar	Noun:Masc:Gen:Sg:DefArt
tsodóg	sodóg	Noun:Fem:Com:Sg:DefArt
tsodhearfacht	sodhearfacht	Noun:Fem:Com:Sg:DefArt
tsodheilbhitheacht	sodheilbhitheacht	Noun:Fem:Com:Sg:DefArt
tsofaisteachais	sofaisteachas	Noun:Masc:Gen:Sg:DefArt
tsofaisticiúlacht	sofaisticiúlacht	Noun:Fem:Com:Sg:DefArt
tsofaistíocht	sofaistíocht	Noun:Fem:Com:Sg:DefArt
tsofaist	sofaist	Noun:Masc:Gen:Sg:DefArt
tsofhreagracht	sofhreagracht	Noun:Fem:Com:Sg:DefArt
tsofhriotail	sofhriotal	Noun:Masc:Gen:Sg:DefArt
tsoghontacht	soghontacht	Noun:Fem:Com:Sg:DefArt
tsoghluaisteacht	soghluaisteacht	Noun:Fem:Com:Sg:DefArt
tsolabharthacht	solabharthacht	Noun:Fem:Com:Sg:DefArt
tsoladais	soladas	Noun:Masc:Gen:Sg:DefArt
tsoladaithe	soladú	Noun:Masc:Gen:Sg:DefArt
tsolamair	solamar	Noun:Masc:Gen:Sg:DefArt
tsolanóidigh	solanóideach	Noun:Masc:Gen:Sg:DefArt
tsolasbhliain	solasbhliain	Noun:Fem:Com:Sg:DefArt
tsolasmhaire	solasmhaire	Noun:Fem:Com:Sg:DefArt
tsolathacht	solathacht	Noun:Fem:Com:Sg:DefArt
tsolaoid	solaoid	Noun:Fem:Com:Sg:DefArt
tsolaid	solad	Noun:Masc:Gen:Sg:DefArt
tsolais	solas	Noun:Masc:Gen:Sg:DefArt
tsola	sola	Noun:Masc:Gen:Sg:DefArt
tsola	sola	Noun:Fem:Com:Sg:DefArt
tsoleáiteacht	soleáiteacht	Noun:Fem:Com:Sg:DefArt
tsoláthair	soláthar	Noun:Masc:Gen:Sg:DefArt
tsoláthraí	soláthraí	Noun:Masc:Gen:Sg:DefArt
tsoléiritheacht	soléiritheacht	Noun:Fem:Com:Sg:DefArt
tsolúbthacht	solúbthacht	Noun:Fem:Com:Sg:DefArt
tsolfatára	solfatára	Noun:Masc:Gen:Sg:DefArt
tsollúin	sollúin	Noun:Fem:Com:Sg:DefArt
tsollúntacht	sollúntacht	Noun:Fem:Com:Sg:DefArt
tsollúnaithe	sollúnú	Noun:Masc:Gen:Sg:DefArt
tsomacháin	somachán	Noun:Masc:Gen:Sg:DefArt
tsomadáin	somadán	Noun:Masc:Gen:Sg:DefArt
tsomóg	somóg	Noun:Fem:Com:Sg:DefArt
tsomhaoin	somhaoin	Noun:Fem:Com:Sg:DefArt
tsomhúinteacht	somhúinteacht	Noun:Fem:Com:Sg:DefArt
tsomhúnlaitheacht	somhúnlaitheacht	Noun:Fem:Com:Sg:DefArt
tsonairte	sonairte	Noun:Fem:Com:Sg:DefArt
tsonaraigh	sonarach	Noun:Masc:Gen:Sg:DefArt
tsonais	sonas	Noun:Masc:Gen:Sg:DefArt
tsonuachair	sonuachar	Noun:Masc:Gen:Sg:DefArt
tsonáidín	sonáidín	Noun:Masc:Gen:Sg:DefArt
tsonáid	sonáid	Noun:Fem:Com:Sg:DefArt
tsonóg	sonóg	Noun:Fem:Com:Sg:DefArt
tsonc	sonc	Noun:Masc:Gen:Sg:DefArt
tsondais	sondas	Noun:Masc:Gen:Sg:DefArt
tsonnaigh	sonnach	Noun:Masc:Gen:Sg:DefArt
tsonnaidh	sonnadh	Noun:Masc:Gen:Sg:DefArt
tsonnghaoth	sonnghaoth	Noun:Fem:Com:Sg:DefArt
tsonraíocht	sonraíocht	Noun:Fem:Com:Sg:DefArt
tsonraisc	sonrasc	Noun:Masc:Gen:Sg:DefArt
tsonra	sonra	Noun:Masc:Gen:Sg:DefArt
tsonrú	sonrú	Noun:Masc:Gen:Sg:DefArt
tsopaireacht	sopaireacht	Noun:Fem:Com:Sg:DefArt
tsopacháin	sopachán	Noun:Masc:Gen:Sg:DefArt
tsopóg	sopóg	Noun:Fem:Com:Sg:DefArt
tsopchinn	sopcheann	Noun:Masc:Gen:Sg:DefArt
tsophléascacht	sophléascacht	Noun:Fem:Com:Sg:DefArt
tsopráin	soprán	Noun:Masc:Gen:Sg:DefArt
tsoraíd	soraíd	Noun:Fem:Com:Sg:DefArt
tsoracháin	sorachán	Noun:Masc:Gen:Sg:DefArt
tsora	sora	Noun:Masc:Gen:Sg:DefArt
tsorithimic	sorithimic	Noun:Fem:Com:Sg:DefArt
tsoráin	során	Noun:Masc:Gen:Sg:DefArt
tsorcais	sorcas	Noun:Masc:Gen:Sg:DefArt
tsorcóra	sorcóir	Noun:Masc:Gen:Sg:DefArt
tsorcha	sorcha	Noun:Fem:Com:Sg:DefArt
tsorcháin	sorchán	Noun:Masc:Gen:Sg:DefArt
tsorgaim	sorgam	Noun:Masc:Gen:Sg:DefArt
tsormáin	sormán	Noun:Masc:Gen:Sg:DefArt
tsornaire	sornaire	Noun:Masc:Gen:Sg:DefArt
tsornáin	sornán	Noun:Masc:Gen:Sg:DefArt
tsornóg	sornóg	Noun:Fem:Com:Sg:DefArt
tsornchoire	sornchoire	Noun:Masc:Gen:Sg:DefArt
tsorthain	sorthan	Noun:Masc:Gen:Sg:DefArt
tsoscéala	soscéala	Noun:Masc:Gen:Sg:DefArt
tsosa	sos	Noun:Masc:Gen:Sg:DefArt
tsotaire	sotaire	Noun:Masc:Gen:Sg:DefArt
tsotail	sotal	Noun:Masc:Gen:Sg:DefArt
tsotair	sotar	Noun:Masc:Gen:Sg:DefArt
tsothaí	sothaí	Noun:Masc:Gen:Sg:DefArt
tsoic	soc	Noun:Masc:Gen:Sg:DefArt
tsoinn	sonn	Noun:Masc:Gen:Sg:DefArt
tsoin	son	Noun:Masc:Gen:Sg:DefArt
tsoip	sop	Noun:Masc:Gen:Sg:DefArt
tsoirb	sorb	Noun:Masc:Gen:Sg:DefArt
tsoirn	sorn	Noun:Masc:Gen:Sg:DefArt
tsoir	sor	Noun:Masc:Gen:Sg:DefArt
tsuibiachtaí	suibiachtaí	Noun:Masc:Gen:Sg:DefArt
tsuibiachtachais	suibiachtachas	Noun:Masc:Gen:Sg:DefArt
tsuibiachtúlacht	suibiachtúlacht	Noun:Fem:Com:Sg:DefArt
tsuibiacht	suibiacht	Noun:Fem:Com:Sg:DefArt
tsuibhiscéil	suibhiscéal	Noun:Masc:Gen:Sg:DefArt
tsuib	suib	Noun:Fem:Com:Sg:DefArt
tsuilficiainíd	suilficiainíd	Noun:Fem:Com:Sg:DefArt
tsuilfíd	suilfíd	Noun:Fem:Com:Sg:DefArt
tsuilfít	suilfít	Noun:Fem:Com:Sg:DefArt
tsuimeáil	suimeáil	Noun:Fem:Com:Sg:DefArt
tsuimeálaí	suimeálaí	Noun:Masc:Gen:Sg:DefArt
tsuimiúcháin	suimiúchán	Noun:Masc:Gen:Sg:DefArt
tsuimiúlacht	suimiúlacht	Noun:Fem:Com:Sg:DefArt
tsuimintithe	suimintiú	Noun:Masc:Gen:Sg:DefArt
tsuimint	suimint	Noun:Fem:Com:Sg:DefArt
tsuimisin	suimisean	Noun:Masc:Gen:Sg:DefArt
tsuimitheora	suimitheoir	Noun:Masc:Gen:Sg:DefArt
tsuimithe	suimiú	Noun:Masc:Gen:Sg:DefArt
tsuim	suim	Noun:Fem:Com:Sg:DefArt
tsuinc	suinc	Noun:Fem:Com:Sg:DefArt
tsuipéir	suipéar	Noun:Masc:Gen:Sg:DefArt
tsuiríocht	suiríocht	Noun:Fem:Com:Sg:DefArt
tsuirígh	suiríoch	Noun:Masc:Gen:Sg:DefArt
tsuirí	suirí	Noun:Fem:Com:Sg:DefArt
tsuirbhéireacht	suirbhéireacht	Noun:Fem:Com:Sg:DefArt
tsuirbhéara	suirbhéir	Noun:Masc:Gen:Sg:DefArt
tsuirbhé	suirbhé	Noun:Masc:Gen:Sg:DefArt
tsuirplís	suirplís	Noun:Fem:Com:Sg:DefArt
tsuiteacht	suiteacht	Noun:Fem:Com:Sg:DefArt
tsuiteoireacht	suiteoireacht	Noun:Fem:Com:Sg:DefArt
tsuiteora	suiteoir	Noun:Masc:Gen:Sg:DefArt
tsuáilce	suáilce	Noun:Fem:Com:Sg:DefArt
tsuáilcis	suáilceas	Noun:Masc:Gen:Sg:DefArt
tsuáv	suáv	Noun:Masc:Gen:Sg:DefArt
tsuáin	suán	Noun:Masc:Gen:Sg:DefArt
tsuíocháin	suíochán	Noun:Masc:Gen:Sg:DefArt
tsuíóg	suíóg	Noun:Fem:Com:Sg:DefArt
tsuímh	suíomh	Noun:Masc:Gen:Sg:DefArt
tsuí	suí	Noun:Masc:Gen:Sg:DefArt
tsuóg	suóg	Noun:Fem:Com:Sg:DefArt
tsubhachais	subhachas	Noun:Masc:Gen:Sg:DefArt
tsubha	subha	Noun:Fem:Com:Sg:DefArt
tsubhchrúsca	subhchrúsca	Noun:Masc:Gen:Sg:DefArt
tsubh	subh	Noun:Fem:Com:Sg:DefArt
tsubstainteachais	substainteachas	Noun:Masc:Gen:Sg:DefArt
tsubstaintiúlacht	substaintiúlacht	Noun:Fem:Com:Sg:DefArt
tsubstaint	substaint	Noun:Fem:Com:Sg:DefArt
tsubstainte	substaineadh	Noun:Masc:Gen:Sg:DefArt
tsubstráit	substráit	Noun:Fem:Com:Sg:DefArt
tsucaí	sucaí	Noun:Masc:Gen:Sg:DefArt
tsufraigéid	sufraigéid	Noun:Fem:Com:Sg:DefArt
tsulcáil	sulcáil	Noun:Fem:Com:Sg:DefArt
tsulfainiolaimíd	sulfainiolaimíd	Noun:Fem:Com:Sg:DefArt
tsulfair	sulfar	Noun:Masc:Gen:Sg:DefArt
tsulfáit	sulfáit	Noun:Fem:Com:Sg:DefArt
tsulfónaimíd	sulfónaimíd	Noun:Fem:Com:Sg:DefArt
tsulfónáit	sulfónáit	Noun:Fem:Com:Sg:DefArt
tsultáin	sultán	Noun:Masc:Gen:Sg:DefArt
tsultmhaireacht	sultmhaireacht	Noun:Fem:Com:Sg:DefArt
tsumaigh	sumach	Noun:Masc:Gen:Sg:DefArt
tsumnadóra	sumnadóir	Noun:Masc:Gen:Sg:DefArt
tsuncaire	suncaire	Noun:Masc:Gen:Sg:DefArt
tsunda	sunda	Noun:Masc:Gen:Sg:DefArt
tsuntasacht	suntasacht	Noun:Fem:Com:Sg:DefArt
tsuntais	suntas	Noun:Masc:Gen:Sg:DefArt
tsura	sura	Noun:Masc:Gen:Sg:DefArt
tsurda	surda	Noun:Masc:Gen:Sg:DefArt
tsursaing	sursaing	Noun:Fem:Com:Sg:DefArt
tsutaigh	sutach	Noun:Masc:Gen:Sg:DefArt
tsuthaineacht	suthaineacht	Noun:Fem:Com:Sg:DefArt
tsuthaireacht	suthaireacht	Noun:Fem:Com:Sg:DefArt
tsuthaire	suthaire	Noun:Masc:Gen:Sg:DefArt
tsutheolaíocht	sutheolaíocht	Noun:Fem:Com:Sg:DefArt
tsuthshaic	suthshac	Noun:Masc:Gen:Sg:DefArt
tsutha	suth	Noun:Masc:Gen:Sg:DefArt
tsutraill	sutrall	Noun:Masc:Gen:Sg:DefArt
tsuaibhreois	suaibhreos	Noun:Masc:Gen:Sg:DefArt
tsuaill	suaill	Noun:Fem:Com:Sg:DefArt
tsuaimhneachais	suaimhneachas	Noun:Masc:Gen:Sg:DefArt
tsuaimhneamáin	suaimhneamán	Noun:Masc:Gen:Sg:DefArt
tsuaimhneasáin	suaimhneasán	Noun:Masc:Gen:Sg:DefArt
tsuaimhnithe	suaimhniú	Noun:Masc:Gen:Sg:DefArt
tsuaimhnis	suaimhneas	Noun:Masc:Gen:Sg:DefArt
tsuainseánaí	suainseánaí	Noun:Masc:Gen:Sg:DefArt
tsuainseáin	suainseán	Noun:Masc:Gen:Sg:DefArt
tsuaircis	suairceas	Noun:Masc:Gen:Sg:DefArt
tsuairtle	suairtle	Noun:Fem:Com:Sg:DefArt
tsuaiteacháin	suaiteachán	Noun:Masc:Gen:Sg:DefArt
tsuaiteacht	suaiteacht	Noun:Fem:Com:Sg:DefArt
tsuaiteora	suaiteoir	Noun:Masc:Gen:Sg:DefArt
tsuaitheantais	suaitheantas	Noun:Masc:Gen:Sg:DefArt
tsuaithinseacht	suaithinseacht	Noun:Fem:Com:Sg:DefArt
tsuaithne	suaithne	Noun:Masc:Gen:Sg:DefArt
tsuaithníocht	suaithníocht	Noun:Fem:Com:Sg:DefArt
tsuaithte	suaitheadh	Noun:Masc:Gen:Sg:DefArt
tsuaitreacht	suaitreacht	Noun:Fem:Com:Sg:DefArt
tsuaitrigh	suaitreach	Noun:Masc:Gen:Sg:DefArt
tsuanaíocht	suanaíocht	Noun:Fem:Com:Sg:DefArt
tsuanaí	suanaí	Noun:Masc:Gen:Sg:DefArt
tsuanacht	suanacht	Noun:Fem:Com:Sg:DefArt
tsuanáin	suanán	Noun:Masc:Gen:Sg:DefArt
tsuanchógais	suanchógas	Noun:Masc:Gen:Sg:DefArt
tsuanghalair	suanghalar	Noun:Masc:Gen:Sg:DefArt
tsuanleasa	suanlios	Noun:Masc:Gen:Sg:DefArt
tsuanmhaireacht	suanmhaireacht	Noun:Fem:Com:Sg:DefArt
tsuansiúlaí	suansiúlaí	Noun:Masc:Gen:Sg:DefArt
tsuansiúil	suansiúl	Noun:Masc:Gen:Sg:DefArt
tsuantraí	suantraí	Noun:Fem:Com:Sg:DefArt
tsuaraíocht	suaraíocht	Noun:Fem:Com:Sg:DefArt
tsuarachais	suarachas	Noun:Masc:Gen:Sg:DefArt
tsuaracháin	suarachán	Noun:Masc:Gen:Sg:DefArt
tsuaróg	suaróg	Noun:Fem:Com:Sg:DefArt
tsuasánaí	suasánaí	Noun:Masc:Gen:Sg:DefArt
tsuasáin	suasán	Noun:Masc:Gen:Sg:DefArt
tsuathaireacht	suathaireacht	Noun:Fem:Com:Sg:DefArt
tsuathaire	suathaire	Noun:Masc:Gen:Sg:DefArt
tsuathais	suathas	Noun:Masc:Gen:Sg:DefArt
tsuathráin	suathrán	Noun:Masc:Gen:Sg:DefArt
tsuain	suan	Noun:Masc:Gen:Sg:DefArt
tsuilt	sult	Noun:Masc:Gen:Sg:DefArt
tsá-phlána	sá-phlána	Noun:Masc:Gen:Sg:DefArt
tsáibhirne	sáibhirne	Noun:Fem:Com:Sg:DefArt
tsáible	sáible	Noun:Masc:Gen:Sg:DefArt
tsáile	sáile	Noun:Masc:Gen:Sg:DefArt
tsáile	sáile	Noun:Fem:Com:Sg:DefArt
tsáilín	sáilín	Noun:Masc:Gen:Sg:DefArt
tsáilghiolla	sáilghiolla	Noun:Masc:Gen:Sg:DefArt
tsáiltéir	sáiltéar	Noun:Masc:Gen:Sg:DefArt
tsáil	sáil	Noun:Fem:Com:Sg:DefArt
tsáimhe	sáimhe	Noun:Fem:Com:Sg:DefArt
tsáimhín	sáimhín	Noun:Masc:Gen:Sg:DefArt
tsáimhríocht	sáimhríocht	Noun:Fem:Com:Sg:DefArt
tsáinn	sáinn	Noun:Fem:Com:Sg:DefArt
tsáirsint	sáirsint	Noun:Masc:Gen:Sg:DefArt
tsáiste	sáiste	Noun:Fem:Com:Sg:DefArt
tsáiteacháin	sáiteachán	Noun:Masc:Gen:Sg:DefArt
tsáiteacht	sáiteacht	Noun:Fem:Com:Sg:DefArt
tsáiteoireacht	sáiteoireacht	Noun:Fem:Com:Sg:DefArt
tsáiteora	sáiteoir	Noun:Masc:Gen:Sg:DefArt
tsáiteáin	sáiteán	Noun:Masc:Gen:Sg:DefArt
tsáithithe	sáithiú	Noun:Masc:Gen:Sg:DefArt
tsáith	sáith	Noun:Fem:Com:Sg:DefArt
tsábhadóireacht	sábhadóireacht	Noun:Fem:Com:Sg:DefArt
tsábhadóra	sábhadóir	Noun:Masc:Gen:Sg:DefArt
tsábháilteacht	sábháilteacht	Noun:Fem:Com:Sg:DefArt
tsábháil	sábháil	Noun:Fem:Com:Sg:DefArt
tsábhálaí	sábhálaí	Noun:Masc:Gen:Sg:DefArt
tsábhchuil	sábhchuil	Noun:Fem:Com:Sg:DefArt
tsábhlóg	sábhlóg	Noun:Fem:Com:Sg:DefArt
tsácráilteacht	sácráilteacht	Noun:Fem:Com:Sg:DefArt
tsácráil	sácráil	Noun:Fem:Com:Sg:DefArt
tsácrálaí	sácrálaí	Noun:Masc:Gen:Sg:DefArt
tsádachais	sádachas	Noun:Masc:Gen:Sg:DefArt
tsádaigh	sádach	Noun:Masc:Gen:Sg:DefArt
tsádair	sádar	Noun:Masc:Gen:Sg:DefArt
tsáfach	sáfach	Noun:Fem:Com:Sg:DefArt
tsága	sága	Noun:Masc:Gen:Sg:DefArt
tságphailm	ságphailm	Noun:Fem:Com:Sg:DefArt
tsálóg	sálóg	Noun:Fem:Com:Sg:DefArt
tsámhaí	sámhaí	Noun:Masc:Gen:Sg:DefArt
tsámhais	sámhas	Noun:Masc:Gen:Sg:DefArt
tsámhánaí	sámhánaí	Noun:Masc:Gen:Sg:DefArt
tsámhántacht	sámhántacht	Noun:Fem:Com:Sg:DefArt
tsámháin	sámhán	Noun:Masc:Gen:Sg:DefArt
tsámhbhréitsín	sámhbhréitsín	Noun:Masc:Gen:Sg:DefArt
tsámhnais	sámhnas	Noun:Masc:Gen:Sg:DefArt
tsámh	sámh	Noun:Fem:Com:Sg:DefArt
tsámhaithe	sámhú	Noun:Masc:Gen:Sg:DefArt
tsár-riail	sár-riail	Noun:Fem:Com:Sg:DefArt
tsáraitheora	sáraitheoir	Noun:Masc:Gen:Sg:DefArt
tsáraíocht	sáraíocht	Noun:Fem:Com:Sg:DefArt
tsáraích	sáraíoch	Noun:Masc:Gen:Sg:DefArt
tsáracháin	sárachán	Noun:Masc:Gen:Sg:DefArt
tsáreolais	sáreolas	Noun:Masc:Gen:Sg:DefArt
tsárobair	sárobair	Noun:Fem:Com:Sg:DefArt
tsárocsaíd	sárocsaíd	Noun:Fem:Com:Sg:DefArt
tsárú	sárú	Noun:Masc:Gen:Sg:DefArt
tsárbheartaithe	sárbheartú	Noun:Masc:Gen:Sg:DefArt
tsárbhliain	sárbhliain	Noun:Fem:Com:Sg:DefArt
tsárchéim	sárchéim	Noun:Fem:Com:Sg:DefArt
tsárchlóráit	sárchlóráit	Noun:Fem:Com:Sg:DefArt
tsárfheasa	sárfhios	Noun:Masc:Gen:Sg:DefArt
tsárheitridín	sárheitridín	Noun:Masc:Gen:Sg:DefArt
tsármhanganáit	sármhanganáit	Noun:Fem:Com:Sg:DefArt
tsárshaothair	sárshaothar	Noun:Masc:Gen:Sg:DefArt
tsárshulfáit	sárshulfáit	Noun:Fem:Com:Sg:DefArt
tsársháithithe	sársháithiú	Noun:Masc:Gen:Sg:DefArt
tsárstoic	sárstoc	Noun:Masc:Gen:Sg:DefArt
tsárthadhaill	sárthadhall	Noun:Masc:Gen:Sg:DefArt
tsásaimh	sásamh	Noun:Masc:Gen:Sg:DefArt
tsásair	sásar	Noun:Masc:Gen:Sg:DefArt
tsásúlacht	sásúlacht	Noun:Fem:Com:Sg:DefArt
tsáslaigh	sáslach	Noun:Masc:Gen:Sg:DefArt
tsáspain	sáspan	Noun:Masc:Gen:Sg:DefArt
tsástaí	sástaí	Noun:Masc:Gen:Sg:DefArt
tsástacht	sástacht	Noun:Fem:Com:Sg:DefArt
tsástoillidh	sástoilleadh	Noun:Masc:Gen:Sg:DefArt
tsáthaca	sáthaca	Noun:Masc:Gen:Sg:DefArt
tsáibh	sábh	Noun:Masc:Gen:Sg:DefArt
tsáich	sách	Noun:Masc:Gen:Sg:DefArt
tsáig	ság	Noun:Masc:Gen:Sg:DefArt
tsáir	sár	Noun:Masc:Gen:Sg:DefArt
tsáis	sás	Noun:Masc:Gen:Sg:DefArt
tsá	sá	Noun:Masc:Gen:Sg:DefArt
tséabú	séabú	Noun:Masc:Gen:Sg:DefArt
tséabra	séabra	Noun:Masc:Gen:Sg:DefArt
tséacla	séacla	Noun:Masc:Gen:Sg:DefArt
tséadaire	séadaire	Noun:Masc:Gen:Sg:DefArt
tséadaíocht	séadaíocht	Noun:Fem:Com:Sg:DefArt
tséadaí	séadaí	Noun:Masc:Gen:Sg:DefArt
tséadchomhartha	séadchomhartha	Noun:Masc:Gen:Sg:DefArt
tséada	séad	Noun:Masc:Gen:Sg:DefArt
tséagma	séagma	Noun:Masc:Gen:Sg:DefArt
tséala	séala	Noun:Masc:Gen:Sg:DefArt
tséaláin	séalán	Noun:Masc:Gen:Sg:DefArt
tséama	séama	Noun:Masc:Gen:Sg:DefArt
tséanaireacht	séanaireacht	Noun:Fem:Com:Sg:DefArt
tséanaire	séanaire	Noun:Masc:Gen:Sg:DefArt
tséanais	séanas	Noun:Masc:Gen:Sg:DefArt
tséanmhaireacht	séanmhaireacht	Noun:Fem:Com:Sg:DefArt
tséansaí	séansaí	Noun:Masc:Gen:Sg:DefArt
tséansúin	séansún	Noun:Masc:Gen:Sg:DefArt
tséans	séans	Noun:Masc:Gen:Sg:DefArt
tséantóra	séantóir	Noun:Masc:Gen:Sg:DefArt
tséanta	séanadh	Noun:Masc:Gen:Sg:DefArt
tséarachais	séarachas	Noun:Masc:Gen:Sg:DefArt
tséaracht	séaracht	Noun:Fem:Com:Sg:DefArt
tséaraigh	séarach	Noun:Masc:Gen:Sg:DefArt
tséasúracht	séasúracht	Noun:Fem:Com:Sg:DefArt
tséasúir	séasúr	Noun:Masc:Gen:Sg:DefArt
tséibe	séibe	Noun:Fem:Com:Sg:DefArt
tséideadáin	séideadán	Noun:Masc:Gen:Sg:DefArt
tséidearnach	séidearnach	Noun:Fem:Com:Sg:DefArt
tséideogacht	séideogacht	Noun:Fem:Com:Sg:DefArt
tséideog	séideog	Noun:Fem:Com:Sg:DefArt
tséideáin	séideán	Noun:Masc:Gen:Sg:DefArt
tséidire	séidire	Noun:Masc:Gen:Sg:DefArt
tséidchomhla	séidchomhla	Noun:Fem:Com:Sg:DefArt
tséidfíl	séidfíl	Noun:Fem:Com:Sg:DefArt
tséidlampa	séidlampa	Noun:Masc:Gen:Sg:DefArt
tséidphíobáin	séidphíobán	Noun:Masc:Gen:Sg:DefArt
tséidil	séideal	Noun:Masc:Gen:Sg:DefArt
tséidte	séideadh	Noun:Masc:Gen:Sg:DefArt
tséiléara	séiléir	Noun:Masc:Gen:Sg:DefArt
tséimeantaic	séimeantaic	Noun:Fem:Com:Sg:DefArt
tséimhanálaithe	séimhanálú	Noun:Masc:Gen:Sg:DefArt
tséimhe	séimhe	Noun:Fem:Com:Sg:DefArt
tséimhiú	séimhiú	Noun:Masc:Gen:Sg:DefArt
tséinne	séinne	Noun:Masc:Gen:Sg:DefArt
tséipéilín	séipéilín	Noun:Masc:Gen:Sg:DefArt
tséipéil	séipéal	Noun:Masc:Gen:Sg:DefArt
tséiplíneacht	séiplíneacht	Noun:Fem:Com:Sg:DefArt
tséiplínigh	séiplíneach	Noun:Masc:Gen:Sg:DefArt
tséireolaíocht	séireolaíocht	Noun:Fem:Com:Sg:DefArt
tséire	séire	Noun:Masc:Gen:Sg:DefArt
tséirseáil	séirseáil	Noun:Fem:Com:Sg:DefArt
tséirseálaí	séirseálaí	Noun:Masc:Gen:Sg:DefArt
tséirse	séirse	Noun:Masc:Gen:Sg:DefArt
tséirsín	séirsín	Noun:Masc:Gen:Sg:DefArt
tséirim	séiream	Noun:Masc:Gen:Sg:DefArt
tséir	séir	Noun:Fem:Com:Sg:DefArt
tséisín	séisín	Noun:Masc:Gen:Sg:DefArt
tséis	séis	Noun:Fem:Com:Sg:DefArt
tséite	séite	Noun:Fem:Com:Sg:DefArt
tséitéireacht	séitéireacht	Noun:Fem:Com:Sg:DefArt
tséitéara	séitéir	Noun:Masc:Gen:Sg:DefArt
tséitreacht	séitreacht	Noun:Fem:Com:Sg:DefArt
tséú	séú	Noun:Masc:Gen:Sg:DefArt
tséin	séan	Noun:Masc:Gen:Sg:DefArt
tsé	sé	Noun:Masc:Gen:Sg:DefArt
tsíobaireacht	síobaireacht	Noun:Fem:Com:Sg:DefArt
tsíobaire	síobaire	Noun:Masc:Gen:Sg:DefArt
tsíoboighir	síoboighear	Noun:Masc:Gen:Sg:DefArt
tsíobáin	síobán	Noun:Masc:Gen:Sg:DefArt
tsíobóid	síobóid	Noun:Fem:Com:Sg:DefArt
tsíobóg	síobóg	Noun:Fem:Com:Sg:DefArt
tsíobhais	síobhas	Noun:Masc:Gen:Sg:DefArt
tsíobha	síobh	Noun:Masc:Gen:Sg:DefArt
tsíobthomhais	síobthomhas	Noun:Masc:Gen:Sg:DefArt
tsíobtha	síobadh	Noun:Masc:Gen:Sg:DefArt
tsíob	síob	Noun:Fem:Com:Sg:DefArt
tsíocanailísí	síocanailísí	Noun:Masc:Gen:Sg:DefArt
tsíocanailís	síocanailís	Noun:Fem:Com:Sg:DefArt
tsíocóis	síocóis	Noun:Fem:Com:Sg:DefArt
tsíocháin	síocháin	Noun:Fem:Com:Sg:DefArt
tsíochánaí	síochánaí	Noun:Masc:Gen:Sg:DefArt
tsíochánachais	síochánachas	Noun:Masc:Gen:Sg:DefArt
tsíochántacht	síochántacht	Noun:Fem:Com:Sg:DefArt
tsíod-drúchta	síod-drúcht	Noun:Masc:Gen:Sg:DefArt
tsíoda	síoda	Noun:Masc:Gen:Sg:DefArt
tsíoda	síoda	Prop:Noun:Masc:Gen:Sg:DefArt
tsíodóg	síodóg	Noun:Fem:Com:Sg:DefArt
tsíodúlacht	síodúlacht	Noun:Fem:Com:Sg:DefArt
tsíodráil	síodráil	Noun:Fem:Com:Sg:DefArt
tsíodrálaí	síodrálaí	Noun:Masc:Gen:Sg:DefArt
tsíofra	síofra	Noun:Masc:Gen:Sg:DefArt
tsíofróireacht	síofróireacht	Noun:Fem:Com:Sg:DefArt
tsíofróra	síofróir	Noun:Masc:Gen:Sg:DefArt
tsíofrógacht	síofrógacht	Noun:Fem:Com:Sg:DefArt
tsíofróg	síofróg	Noun:Fem:Com:Sg:DefArt
tsíogaíocht	síogaíocht	Noun:Fem:Com:Sg:DefArt
tsíogaí	síogaí	Noun:Masc:Gen:Sg:DefArt
tsíogáin	síogán	Noun:Masc:Gen:Sg:DefArt
tsíog	síog	Noun:Fem:Com:Sg:DefArt
tsíolaicme	síolaicme	Noun:Fem:Com:Sg:DefArt
tsíolaí	síolaí	Noun:Masc:Gen:Sg:DefArt
tsíoladóireacht	síoladóireacht	Noun:Fem:Com:Sg:DefArt
tsíoladóra	síoladóir	Noun:Masc:Gen:Sg:DefArt
tsíoláin	síolán	Noun:Masc:Gen:Sg:DefArt
tsíológ	síológ	Noun:Fem:Com:Sg:DefArt
tsíolbhaigh	síolbhach	Noun:Masc:Gen:Sg:DefArt
tsíolchuir	síolchur	Noun:Masc:Gen:Sg:DefArt
tsíolghé	síolghé	Noun:Fem:Com:Sg:DefArt
tsíollann	síollann	Noun:Fem:Com:Sg:DefArt
tsíolmhaireacht	síolmhaireacht	Noun:Fem:Com:Sg:DefArt
tsíolphlanda	síolphlanda	Noun:Masc:Gen:Sg:DefArt
tsíolraitheora	síolraitheoir	Noun:Masc:Gen:Sg:DefArt
tsíolraigh	síolrach	Noun:Masc:Gen:Sg:DefArt
tsíolrú	síolrú	Noun:Masc:Gen:Sg:DefArt
tsíolta	síolta	Noun:Fem:Com:Sg:DefArt
tsíolaithe	síolú	Noun:Masc:Gen:Sg:DefArt
tsíoma	síoma	Noun:Masc:Gen:Sg:DefArt
tsíomáis	síomáis	Noun:Fem:Com:Sg:DefArt
tsíománaíocht	síománaíocht	Noun:Fem:Com:Sg:DefArt
tsíománaí	síománaí	Noun:Masc:Gen:Sg:DefArt
tsíomáin	síomán	Noun:Masc:Gen:Sg:DefArt
tsíomóis	síomóis	Noun:Fem:Com:Sg:DefArt
tsíomóntaí	síomóntaí	Noun:Masc:Gen:Sg:DefArt
tsíomóntacht	síomóntacht	Noun:Fem:Com:Sg:DefArt
tsíonáin	síonán	Noun:Masc:Gen:Sg:DefArt
tsíonchaithimh	síonchaitheamh	Noun:Masc:Gen:Sg:DefArt
tsíondaire	síondaire	Noun:Masc:Gen:Sg:DefArt
tsíonmheilt	síonmheilt	Noun:Fem:Com:Sg:DefArt
tsíonra	síonra	Noun:Masc:Gen:Sg:DefArt
tsíon	síon	Noun:Fem:Com:Sg:DefArt
tsíoraíocht	síoraíocht	Noun:Fem:Com:Sg:DefArt
tsíoróip	síoróip	Noun:Fem:Com:Sg:DefArt
tsíorchaint	síorchaint	Noun:Fem:Com:Sg:DefArt
tsíota	síota	Noun:Masc:Gen:Sg:DefArt
tsíothadóra	síothadóir	Noun:Masc:Gen:Sg:DefArt
tsíothóilteacht	síothóilteacht	Noun:Fem:Com:Sg:DefArt
tsíothú	síothú	Noun:Masc:Gen:Sg:DefArt
tsíothláin	síothlán	Noun:Masc:Gen:Sg:DefArt
tsíothlóra	síothlóir	Noun:Masc:Gen:Sg:DefArt
tsíothlú	síothlú	Noun:Masc:Gen:Sg:DefArt
tsíothmhaoir	síothmhaor	Noun:Masc:Gen:Sg:DefArt
tsíothnaíl	síothnaíl	Noun:Fem:Com:Sg:DefArt
tsíothnaí	síothnaí	Noun:Masc:Gen:Sg:DefArt
tsíúlacht	síúlacht	Noun:Fem:Com:Sg:DefArt
tsíbín	síbín	Noun:Masc:Gen:Sg:DefArt
tsíbhruíon	síbhruíon	Noun:Fem:Com:Sg:DefArt
tsíceacht	síceacht	Noun:Fem:Com:Sg:DefArt
tsíceapataigh	síceapatach	Noun:Masc:Gen:Sg:DefArt
tsíceolaíocht	síceolaíocht	Noun:Fem:Com:Sg:DefArt
tsíceolaí	síceolaí	Noun:Masc:Gen:Sg:DefArt
tsíciatraí	síciatraí	Noun:Masc:Gen:Sg:DefArt
tsíciatracht	síciatracht	Noun:Fem:Com:Sg:DefArt
tsícifisic	sícifisic	Noun:Fem:Com:Sg:DefArt
tsíciméadracht	síciméadracht	Noun:Fem:Com:Sg:DefArt
tsícinéaróis	sícinéaróis	Noun:Fem:Com:Sg:DefArt
tsíciteiripe	síciteiripe	Noun:Fem:Com:Sg:DefArt
tsícriméadair	sícriméadar	Noun:Masc:Gen:Sg:DefArt
tsícis	síceas	Noun:Masc:Gen:Sg:DefArt
tsíc	síc	Noun:Masc:Gen:Sg:DefArt
tsífias	sífias	Noun:Masc:Gen:Sg:DefArt
tsífisteirnim	sífisteirneam	Noun:Masc:Gen:Sg:DefArt
tsíleáil	síleáil	Noun:Fem:Com:Sg:DefArt
tsíleálaigh	síleálach	Noun:Masc:Gen:Sg:DefArt
tsílne	sílne	Noun:Masc:Gen:Sg:DefArt
tsílte	síleadh	Noun:Masc:Gen:Sg:DefArt
tsíniméadair	síniméadar	Noun:Masc:Gen:Sg:DefArt
tsínitheora	sínitheoir	Noun:Masc:Gen:Sg:DefArt
tsínithe	síniú	Noun:Masc:Gen:Sg:DefArt
tsínéachais	sínéachas	Noun:Masc:Gen:Sg:DefArt
tsínéalaigh	sínéalach	Noun:Masc:Gen:Sg:DefArt
tsínéid	sínéad	Noun:Masc:Gen:Sg:DefArt
tsínteacht	sínteacht	Noun:Fem:Com:Sg:DefArt
tsíntealaigh	síntealach	Noun:Masc:Gen:Sg:DefArt
tsínteoireacht	sínteoireacht	Noun:Fem:Com:Sg:DefArt
tsínteora	sínteoir	Noun:Masc:Gen:Sg:DefArt
tsínteánaí	sínteánaí	Noun:Masc:Gen:Sg:DefArt
tsínteáin	sínteán	Noun:Masc:Gen:Sg:DefArt
tsíntiúsóra	síntiúsóir	Noun:Masc:Gen:Sg:DefArt
tsíntiúis	síntiús	Noun:Masc:Gen:Sg:DefArt
tsíntigh	sínteach	Noun:Masc:Gen:Sg:DefArt
tsínis	síneas	Noun:Masc:Gen:Sg:DefArt
tsín	sín	Noun:Fem:Com:Sg:DefArt
tsípéara	sípéir	Noun:Masc:Gen:Sg:DefArt
tsíprisín	síprisín	Noun:Masc:Gen:Sg:DefArt
tsípris	sípris	Noun:Fem:Com:Sg:DefArt
tsíreacht	síreacht	Noun:Fem:Com:Sg:DefArt
tsíréanaigh	síréanach	Noun:Masc:Gen:Sg:DefArt
tsír	sír	Noun:Fem:Com:Sg:DefArt
tsíscéil	síscéal	Noun:Masc:Gen:Sg:DefArt
tsíte	síte	Noun:Masc:Gen:Sg:DefArt
tsíth	síth	Noun:Fem:Com:Sg:DefArt
tsíl	síol	Noun:Masc:Gen:Sg:DefArt
tsí	sí	Noun:Masc:Gen:Sg:DefArt
tsóidiam	sóidiam	Noun:Masc:Gen:Sg:DefArt
tsóid	sóid	Noun:Fem:Com:Sg:DefArt
tsóimít	sóimít	Noun:Fem:Com:Sg:DefArt
tsóinseáil	sóinseáil	Noun:Fem:Com:Sg:DefArt
tsóisialaí	sóisialaí	Noun:Masc:Gen:Sg:DefArt
tsóisialachais	sóisialachas	Noun:Masc:Gen:Sg:DefArt
tsóisialaithe	sóisialú	Noun:Masc:Gen:Sg:DefArt
tsóisir	sóisear	Noun:Masc:Gen:Sg:DefArt
tsóiteora	sóiteoir	Noun:Masc:Gen:Sg:DefArt
tsóivéid	sóivéid	Noun:Fem:Com:Sg:DefArt
tsóúlacht	sóúlacht	Noun:Fem:Com:Sg:DefArt
tsócamais	sócamas	Noun:Masc:Gen:Sg:DefArt
tsócaid	sócad	Noun:Masc:Gen:Sg:DefArt
tsócúlacht	sócúlacht	Noun:Fem:Com:Sg:DefArt
tsócúil	sócúl	Noun:Masc:Gen:Sg:DefArt
tsóchais	sóchas	Noun:Masc:Gen:Sg:DefArt
tsócháin	sóchán	Noun:Masc:Gen:Sg:DefArt
tsócmhainneacht	sócmhainneacht	Noun:Fem:Com:Sg:DefArt
tsócmhainn	sócmhainn	Noun:Fem:Com:Sg:DefArt
tsólaisteora	sólaisteoir	Noun:Masc:Gen:Sg:DefArt
tsólásaí	sólásaí	Noun:Masc:Gen:Sg:DefArt
tsóláis	sólás	Noun:Masc:Gen:Sg:DefArt
tsólfá	sólfá	Noun:Masc:Gen:Sg:DefArt
tsómasáin	sómasán	Noun:Masc:Gen:Sg:DefArt
tsómais	sómas	Noun:Masc:Gen:Sg:DefArt
tsópa	sópa	Noun:Masc:Gen:Sg:DefArt
tsórtálaí	sórtálaí	Noun:Masc:Gen:Sg:DefArt
tsóidh	sódh	Noun:Masc:Gen:Sg:DefArt
tsóil	sól	Noun:Masc:Gen:Sg:DefArt
tsóirt	sórt	Noun:Masc:Gen:Sg:DefArt
tsó	só	Noun:Masc:Gen:Sg:DefArt
tsúibrinithe	súibriniú	Noun:Masc:Gen:Sg:DefArt
tsúibrin	súibrin	Noun:Fem:Com:Sg:DefArt
tsúicheacht	súicheacht	Noun:Fem:Com:Sg:DefArt
tsúiche	súiche	Noun:Masc:Gen:Sg:DefArt
tsúil-lia	súil-lia	Noun:Masc:Gen:Sg:DefArt
tsúilaithne	súilaithne	Noun:Fem:Com:Sg:DefArt
tsúileacháin	súileachán	Noun:Masc:Gen:Sg:DefArt
tsúileog	súileog	Noun:Fem:Com:Sg:DefArt
tsúilíocht	súilíocht	Noun:Fem:Com:Sg:DefArt
tsúilín	súilín	Noun:Masc:Gen:Sg:DefArt
tsúilfhéachaint	súilfhéachaint	Noun:Fem:Com:Sg:DefArt
tsúil	súil	Noun:Fem:Com:Sg:DefArt
tsúimíneacht	súimíneacht	Noun:Fem:Com:Sg:DefArt
tsúimín	súimín	Noun:Masc:Gen:Sg:DefArt
tsúinte	súinte	Noun:Masc:Gen:Sg:DefArt
tsúipín	súipín	Noun:Masc:Gen:Sg:DefArt
tsúire	súire	Noun:Masc:Gen:Sg:DefArt
tsúisín	súisín	Noun:Masc:Gen:Sg:DefArt
tsúisteora	súisteoir	Noun:Masc:Gen:Sg:DefArt
tsúisteáil	súisteáil	Noun:Fem:Com:Sg:DefArt
tsúisteálaí	súisteálaí	Noun:Masc:Gen:Sg:DefArt
tsúiste	súiste	Noun:Masc:Gen:Sg:DefArt
tsúiteacht	súiteacht	Noun:Fem:Com:Sg:DefArt
tsúiteamais	súiteamas	Noun:Masc:Gen:Sg:DefArt
tsúiteora	súiteoir	Noun:Masc:Gen:Sg:DefArt
tsúiteáin	súiteán	Noun:Masc:Gen:Sg:DefArt
tsúitidh	súiteadh	Noun:Masc:Gen:Sg:DefArt
tsúchaiteacht	súchaiteacht	Noun:Fem:Com:Sg:DefArt
tsúcháin	súchán	Noun:Masc:Gen:Sg:DefArt
tsúdaireacht	súdaireacht	Noun:Fem:Com:Sg:DefArt
tsúdaire	súdaire	Noun:Masc:Gen:Sg:DefArt
tsúfartaigh	súfartach	Noun:Masc:Gen:Sg:DefArt
tsúgaire	súgaire	Noun:Masc:Gen:Sg:DefArt
tsúgachais	súgachas	Noun:Masc:Gen:Sg:DefArt
tsúgaigh	súgach	Noun:Masc:Gen:Sg:DefArt
tsúgáin	súgán	Noun:Masc:Gen:Sg:DefArt
tsúgracht	súgracht	Noun:Fem:Com:Sg:DefArt
tsúlachais	súlachas	Noun:Masc:Gen:Sg:DefArt
tsúlaigh	súlach	Noun:Masc:Gen:Sg:DefArt
tsúláin	súlán	Noun:Masc:Gen:Sg:DefArt
tsúmaireacht	súmaireacht	Noun:Fem:Com:Sg:DefArt
tsúmaire	súmaire	Noun:Masc:Gen:Sg:DefArt
tsúmadóra	súmadóir	Noun:Masc:Gen:Sg:DefArt
tsúmóg	súmóg	Noun:Fem:Com:Sg:DefArt
tsúmhaireacht	súmhaireacht	Noun:Fem:Com:Sg:DefArt
tsúpair	súpar	Noun:Masc:Gen:Sg:DefArt
tsúpláil	súpláil	Noun:Fem:Com:Sg:DefArt
tsúracálaí	súracálaí	Noun:Masc:Gen:Sg:DefArt
tsúraic	súrac	Noun:Masc:Gen:Sg:DefArt
tsúraim	súram	Noun:Masc:Gen:Sg:DefArt
tsúsafóin	súsafón	Noun:Masc:Gen:Sg:DefArt
tsúsa	súsa	Noun:Masc:Gen:Sg:DefArt
tsúsáin	súsán	Noun:Masc:Gen:Sg:DefArt
tsútamais	sútamas	Noun:Masc:Gen:Sg:DefArt
tsútair	sútar	Noun:Masc:Gen:Sg:DefArt
tsútáin	sútán	Noun:Masc:Gen:Sg:DefArt
tsútróg	sútróg	Noun:Fem:Com:Sg:DefArt
tsúip	súp	Noun:Masc:Gen:Sg:DefArt
tsúir	súr	Noun:Masc:Gen:Sg:DefArt
tsú	sú	Noun:Masc:Gen:Sg:DefArt
tslaidín	slaidín	Noun:Masc:Gen:Sg:DefArt
tslaidhe	slaidhe	Noun:Fem:Com:Sg:DefArt
tslaidhridh	slaidhreadh	Noun:Masc:Gen:Sg:DefArt
tslaig	slaig	Noun:Fem:Com:Sg:DefArt
tslaimiceáil	slaimiceáil	Noun:Fem:Com:Sg:DefArt
tslaimiceálaí	slaimiceálaí	Noun:Masc:Gen:Sg:DefArt
tslaimice	slaimice	Noun:Masc:Gen:Sg:DefArt
tslaipistéireacht	slaipistéireacht	Noun:Fem:Com:Sg:DefArt
tslaisire	slaisire	Noun:Masc:Gen:Sg:DefArt
tslais	slais	Noun:Fem:Com:Sg:DefArt
tslaitín	slaitín	Noun:Fem:Com:Sg:DefArt
tslaba	slaba	Noun:Masc:Gen:Sg:DefArt
tslabáil	slabáil	Noun:Fem:Com:Sg:DefArt
tslabálaí	slabálaí	Noun:Masc:Gen:Sg:DefArt
tslabóg	slabóg	Noun:Fem:Com:Sg:DefArt
tslabhairín	slabhairín	Noun:Masc:Gen:Sg:DefArt
tslabhra	slabhra	Noun:Masc:Gen:Sg:DefArt
tslabhra	slabhra	Noun:Fem:Com:Sg:DefArt
tslabhráil	slabhráil	Noun:Fem:Com:Sg:DefArt
tslabhrálaí	slabhrálaí	Noun:Masc:Gen:Sg:DefArt
tslacairt	slacairt	Noun:Fem:Com:Sg:DefArt
tslacaí	slacaí	Noun:Masc:Gen:Sg:DefArt
tslacáin	slacán	Noun:Masc:Gen:Sg:DefArt
tslachtaitheora	slachtaitheoir	Noun:Masc:Gen:Sg:DefArt
tslachtmhaireacht	slachtmhaireacht	Noun:Fem:Com:Sg:DefArt
tslachta	slacht	Noun:Masc:Gen:Sg:DefArt
tsladaíocht	sladaíocht	Noun:Fem:Com:Sg:DefArt
tsladaí	sladaí	Noun:Masc:Gen:Sg:DefArt
tsladchonrtha	sladchonradh	Noun:Masc:Gen:Sg:DefArt
tsladmhargaidh	sladmhargadh	Noun:Masc:Gen:Sg:DefArt
tsladphraghais	sladphraghas	Noun:Masc:Gen:Sg:DefArt
tslada	slad	Noun:Masc:Gen:Sg:DefArt
tslaghdáin	slaghdán	Noun:Masc:Gen:Sg:DefArt
tslamaire	slamaire	Noun:Masc:Gen:Sg:DefArt
tslamairt	slamairt	Noun:Fem:Com:Sg:DefArt
tslamair	slamar	Noun:Masc:Gen:Sg:DefArt
tslamáis	slamás	Noun:Masc:Gen:Sg:DefArt
tslamfhocail	slamfhocal	Noun:Masc:Gen:Sg:DefArt
tslampair	slampar	Noun:Masc:Gen:Sg:DefArt
tslapaireacht	slapaireacht	Noun:Fem:Com:Sg:DefArt
tslapaire	slapaire	Noun:Masc:Gen:Sg:DefArt
tslaparnach	slaparnach	Noun:Fem:Com:Sg:DefArt
tslapair	slapar	Noun:Masc:Gen:Sg:DefArt
tslapóg	slapóg	Noun:Fem:Com:Sg:DefArt
tslapraigh	slaprach	Noun:Masc:Gen:Sg:DefArt
tslascairt	slascairt	Noun:Fem:Com:Sg:DefArt
tslataire	slataire	Noun:Masc:Gen:Sg:DefArt
tslatamáil	slatamáil	Noun:Fem:Com:Sg:DefArt
tslatiarainn	slatiarann	Noun:Masc:Gen:Sg:DefArt
tslatóra	slatóir	Noun:Masc:Gen:Sg:DefArt
tslatóg	slatóg	Noun:Fem:Com:Sg:DefArt
tslatbhalla	slatbhalla	Noun:Masc:Gen:Sg:DefArt
tslatfhoilt	slatfholt	Noun:Masc:Gen:Sg:DefArt
tslatfhir	slatfhear	Noun:Masc:Gen:Sg:DefArt
tslathairt	slathairt	Noun:Fem:Com:Sg:DefArt
tslat	slat	Noun:Fem:Com:Sg:DefArt
tslaoiste	slaoiste	Noun:Masc:Gen:Sg:DefArt
tslaodaíocht	slaodaíocht	Noun:Fem:Com:Sg:DefArt
tslaodaí	slaodaí	Noun:Masc:Gen:Sg:DefArt
tslaodacht	slaodacht	Noun:Fem:Com:Sg:DefArt
tslaodmhéadair	slaodmhéadar	Noun:Masc:Gen:Sg:DefArt
tslaoda	slaod	Noun:Masc:Gen:Sg:DefArt
tsleaic	sleaic	Noun:Fem:Com:Sg:DefArt
tsleaidí	sleaidí	Noun:Masc:Gen:Sg:DefArt
tsleaingleáil	sleaingleáil	Noun:Fem:Com:Sg:DefArt
tsleaingir	sleaingear	Noun:Masc:Gen:Sg:DefArt
tsleaint	sleaint	Noun:Fem:Com:Sg:DefArt
tsleabhaic	sleabhac	Noun:Masc:Gen:Sg:DefArt
tsleabhcáin	sleabhcán	Noun:Masc:Gen:Sg:DefArt
tsleachta	sleachtadh	Noun:Masc:Gen:Sg:DefArt
tsleamchúis	sleamchúis	Noun:Fem:Com:Sg:DefArt
tsleamhaine	sleamhaine	Noun:Fem:Com:Sg:DefArt
tsleamhnacháin	sleamhnachán	Noun:Masc:Gen:Sg:DefArt
tsleamhnadóra	sleamhnadóir	Noun:Masc:Gen:Sg:DefArt
tsleamhnánaí	sleamhnánaí	Noun:Masc:Gen:Sg:DefArt
tsleamhnáin	sleamhnán	Noun:Masc:Gen:Sg:DefArt
tsleamhnóg	sleamhnóg	Noun:Fem:Com:Sg:DefArt
tsleamhnaithe	sleamhnú	Noun:Masc:Gen:Sg:DefArt
tsleanntaigh	sleanntach	Noun:Masc:Gen:Sg:DefArt
tsleanntóg	sleanntóg	Noun:Fem:Com:Sg:DefArt
tsleasáin	sleasán	Noun:Masc:Gen:Sg:DefArt
tsleádóireacht	sleádóireacht	Noun:Fem:Com:Sg:DefArt
tsleádóra	sleádóir	Noun:Masc:Gen:Sg:DefArt
tsleánadóra	sleánadóir	Noun:Masc:Gen:Sg:DefArt
tsleáin	sleán	Noun:Masc:Gen:Sg:DefArt
tsleá	sleá	Noun:Fem:Com:Sg:DefArt
tsliabhraoin	sliabhraon	Noun:Masc:Gen:Sg:DefArt
tsliastáin	sliastán	Noun:Masc:Gen:Sg:DefArt
tsliobáin	sliobán	Noun:Masc:Gen:Sg:DefArt
tsliochtaigh	sliochtach	Noun:Masc:Gen:Sg:DefArt
tsliodarnach	sliodarnach	Noun:Fem:Com:Sg:DefArt
tsliodchomhla	sliodchomhla	Noun:Fem:Com:Sg:DefArt
tsliogánaigh	sliogánach	Noun:Masc:Gen:Sg:DefArt
tsliogáin	sliogán	Noun:Masc:Gen:Sg:DefArt
tsliomaigh	sliomach	Noun:Masc:Gen:Sg:DefArt
tsliopacháin	sliopachán	Noun:Masc:Gen:Sg:DefArt
tslioparnach	slioparnach	Noun:Fem:Com:Sg:DefArt
tsliopaigh	sliopach	Noun:Masc:Gen:Sg:DefArt
tsliosamhairc	sliosamharc	Noun:Masc:Gen:Sg:DefArt
tslioschló	slioschló	Noun:Masc:Gen:Sg:DefArt
tsliosfhuinneog	sliosfhuinneog	Noun:Fem:Com:Sg:DefArt
tsliosphoill	sliospholl	Noun:Masc:Gen:Sg:DefArt
tsliotair	sliotar	Noun:Masc:Gen:Sg:DefArt
tsliotáin	sliotán	Noun:Masc:Gen:Sg:DefArt
tsliúcaiméara	sliúcaiméir	Noun:Masc:Gen:Sg:DefArt
tsliúdrálaí	sliúdrálaí	Noun:Masc:Gen:Sg:DefArt
tsliútair	sliútar	Noun:Masc:Gen:Sg:DefArt
tsliútracháin	sliútrachán	Noun:Masc:Gen:Sg:DefArt
tsliútráil	sliútráil	Noun:Fem:Com:Sg:DefArt
tsliú	sliú	Noun:Masc:Gen:Sg:DefArt
tslibire	slibire	Noun:Masc:Gen:Sg:DefArt
tslibreáil	slibreáil	Noun:Fem:Com:Sg:DefArt
tslibreálaí	slibreálaí	Noun:Masc:Gen:Sg:DefArt
tslige	slige	Noun:Masc:Gen:Sg:DefArt
tsligire	sligire	Noun:Masc:Gen:Sg:DefArt
tsligín	sligín	Noun:Masc:Gen:Sg:DefArt
tslighe	slighe	Noun:Masc:Gen:Sg:DefArt
tsligreach	sligreach	Noun:Fem:Com:Sg:DefArt
tsligigh	sligeach	Noun:Masc:Gen:Sg:DefArt
tslime	slime	Noun:Fem:Com:Sg:DefArt
tslincín	slincín	Noun:Masc:Gen:Sg:DefArt
tslinneadóireacht	slinneadóireacht	Noun:Fem:Com:Sg:DefArt
tslinneadóra	slinneadóir	Noun:Masc:Gen:Sg:DefArt
tslinneáin	slinneán	Noun:Masc:Gen:Sg:DefArt
tslinnteog	slinnteog	Noun:Fem:Com:Sg:DefArt
tslinntigh	slinnteach	Noun:Masc:Gen:Sg:DefArt
tslinn	slinn	Noun:Fem:Com:Sg:DefArt
tslipéir	slipéar	Noun:Masc:Gen:Sg:DefArt
tslip	slip	Noun:Fem:Com:Sg:DefArt
tsliseog	sliseog	Noun:Fem:Com:Sg:DefArt
tslisín	slisín	Noun:Masc:Gen:Sg:DefArt
tslisbhuille	slisbhuille	Noun:Masc:Gen:Sg:DefArt
tslisneora	slisneoir	Noun:Masc:Gen:Sg:DefArt
tslisne	slisne	Noun:Masc:Gen:Sg:DefArt
tslisnigh	slisneach	Noun:Masc:Gen:Sg:DefArt
tslis	slis	Noun:Fem:Com:Sg:DefArt
tsléibhe	sliabh	Noun:Masc:Gen:Sg:DefArt
tsleachta	sliocht	Noun:Masc:Gen:Sg:DefArt
tsloigisc	sloigisc	Noun:Fem:Com:Sg:DefArt
tsloigín	sloigín	Noun:Masc:Gen:Sg:DefArt
tsloinne	sloinne	Noun:Masc:Gen:Sg:DefArt
tsloinnteoireacht	sloinnteoireacht	Noun:Fem:Com:Sg:DefArt
tsloinnteora	sloinnteoir	Noun:Masc:Gen:Sg:DefArt
tsloinnidh	sloinneadh	Noun:Masc:Gen:Sg:DefArt
tsloitheáin	sloitheán	Noun:Masc:Gen:Sg:DefArt
tsloit	sloit	Noun:Fem:Com:Sg:DefArt
tslocadóra	slocadóir	Noun:Masc:Gen:Sg:DefArt
tslocáin	slocán	Noun:Masc:Gen:Sg:DefArt
tsloda	sloda	Noun:Masc:Gen:Sg:DefArt
tslodáin	slodán	Noun:Masc:Gen:Sg:DefArt
tslogaide	slogaide	Noun:Fem:Com:Sg:DefArt
tslogaireacht	slogaireacht	Noun:Fem:Com:Sg:DefArt
tslogaire	slogaire	Noun:Masc:Gen:Sg:DefArt
tslogarnach	slogarnach	Noun:Fem:Com:Sg:DefArt
tslogaidh	slogadh	Noun:Masc:Gen:Sg:DefArt
tslogóg	slogóg	Noun:Fem:Com:Sg:DefArt
tslograigh	slograch	Noun:Masc:Gen:Sg:DefArt
tslosóg	slosóg	Noun:Fem:Com:Sg:DefArt
tsloic	sloc	Noun:Masc:Gen:Sg:DefArt
tsloig	slog	Noun:Masc:Gen:Sg:DefArt
tsloinn	slonn	Noun:Masc:Gen:Sg:DefArt
tsluga	sluga	Noun:Masc:Gen:Sg:DefArt
tsluma	sluma	Noun:Masc:Gen:Sg:DefArt
tslupairt	slupairt	Noun:Fem:Com:Sg:DefArt
tslusaíocht	slusaíocht	Noun:Fem:Com:Sg:DefArt
tslusaí	slusaí	Noun:Masc:Gen:Sg:DefArt
tsluaisteora	sluaisteoir	Noun:Masc:Gen:Sg:DefArt
tsluaisteog	sluaisteog	Noun:Fem:Com:Sg:DefArt
tsluaistrithe	sluaistriú	Noun:Masc:Gen:Sg:DefArt
tsluaíocht	sluaíocht	Noun:Fem:Com:Sg:DefArt
tsluamhallacht	sluamhallacht	Noun:Fem:Com:Sg:DefArt
tslua	slua	Noun:Masc:Gen:Sg:DefArt
tsláimínteacht	sláimínteacht	Noun:Fem:Com:Sg:DefArt
tsláimín	sláimín	Noun:Masc:Gen:Sg:DefArt
tsláine	sláine	Noun:Fem:Com:Sg:DefArt
tsláinteachais	sláinteachas	Noun:Masc:Gen:Sg:DefArt
tsláinteolaíocht	sláinteolaíocht	Noun:Fem:Com:Sg:DefArt
tsláinteolaí	sláinteolaí	Noun:Masc:Gen:Sg:DefArt
tsláinte	sláinte	Noun:Fem:Com:Sg:DefArt
tsláintiúlacht	sláintiúlacht	Noun:Fem:Com:Sg:DefArt
tsláintíocht	sláintíocht	Noun:Fem:Com:Sg:DefArt
tsláintí	sláintí	Noun:Masc:Gen:Sg:DefArt
tslámálaí	slámálaí	Noun:Masc:Gen:Sg:DefArt
tslámáin	slámán	Noun:Masc:Gen:Sg:DefArt
tslámóg	slámóg	Noun:Fem:Com:Sg:DefArt
tslám	slám	Noun:Masc:Gen:Sg:DefArt
tslánaitheora	slánaitheoir	Noun:Masc:Gen:Sg:DefArt
tslánaíocht	slánaíocht	Noun:Fem:Com:Sg:DefArt
tslánaí	slánaí	Noun:Masc:Gen:Sg:DefArt
tslánuimhir	slánuimhir	Noun:Fem:Com:Sg:DefArt
tslánú	slánú	Noun:Masc:Gen:Sg:DefArt
tslánchearnóg	slánchearnóg	Noun:Fem:Com:Sg:DefArt
tslánchiúib	slánchiúb	Noun:Masc:Gen:Sg:DefArt
tslánchuid	slánchuid	Noun:Fem:Com:Sg:DefArt
tslándáil	slándáil	Noun:Fem:Com:Sg:DefArt
tslánlusa	slánlus	Noun:Masc:Gen:Sg:DefArt
tslátóg	slátóg	Noun:Fem:Com:Sg:DefArt
tsláthaí	sláthaí	Noun:Fem:Com:Sg:DefArt
tsláthaigh	sláthach	Noun:Masc:Gen:Sg:DefArt
tsláid	slád	Noun:Masc:Gen:Sg:DefArt
tsláin	slán	Noun:Masc:Gen:Sg:DefArt
tsléachta	sléacht	Noun:Masc:Gen:Sg:DefArt
tsléachta	sléachtadh	Noun:Masc:Gen:Sg:DefArt
tsléibhín	sléibhín	Noun:Masc:Gen:Sg:DefArt
tsléibhteoireacht	sléibhteoireacht	Noun:Fem:Com:Sg:DefArt
tsléibhteora	sléibhteoir	Noun:Masc:Gen:Sg:DefArt
tsléibhteánaigh	sléibhteánach	Noun:Masc:Gen:Sg:DefArt
tsléibhtiúlacht	sléibhtiúlacht	Noun:Fem:Com:Sg:DefArt
tsléidíocht	sléidíocht	Noun:Fem:Com:Sg:DefArt
tsléim	sléim	Noun:Fem:Com:Sg:DefArt
tslíocaíocht	slíocaíocht	Noun:Fem:Com:Sg:DefArt
tslíocleac	slíocleac	Noun:Fem:Com:Sg:DefArt
tslíodóireacht	slíodóireacht	Noun:Fem:Com:Sg:DefArt
tslíodóra	slíodóir	Noun:Masc:Gen:Sg:DefArt
tslíogairt	slíogart	Noun:Masc:Gen:Sg:DefArt
tslíomacháin	slíomachán	Noun:Masc:Gen:Sg:DefArt
tslíomadóireacht	slíomadóireacht	Noun:Fem:Com:Sg:DefArt
tslíomadóra	slíomadóir	Noun:Masc:Gen:Sg:DefArt
tslíomóg	slíomóg	Noun:Fem:Com:Sg:DefArt
tslíbeog	slíbeog	Noun:Fem:Com:Sg:DefArt
tslíbhíneacht	slíbhíneacht	Noun:Fem:Com:Sg:DefArt
tslíbhín	slíbhín	Noun:Masc:Gen:Sg:DefArt
tslítheántacht	slítheántacht	Noun:Fem:Com:Sg:DefArt
tslí	slí	Noun:Fem:Com:Sg:DefArt
tslóbairt	slóbairt	Noun:Fem:Com:Sg:DefArt
tslóchtaigh	slóchtach	Noun:Masc:Gen:Sg:DefArt
tslóchtáin	slóchtán	Noun:Masc:Gen:Sg:DefArt
tslóchta	slócht	Noun:Masc:Gen:Sg:DefArt
tslógaidh	slógadh	Noun:Masc:Gen:Sg:DefArt
tslópaire	slópaire	Noun:Masc:Gen:Sg:DefArt
tslópáil	slópáil	Noun:Fem:Com:Sg:DefArt
tslúisteoireacht	slúisteoireacht	Noun:Fem:Com:Sg:DefArt
tslúiste	slúiste	Noun:Masc:Gen:Sg:DefArt
tslúpa	slúpa	Noun:Masc:Gen:Sg:DefArt
tsnaidhmeacht	snaidhmeacht	Noun:Fem:Com:Sg:DefArt
tsnaidhmeadóra	snaidhmeadóir	Noun:Masc:Gen:Sg:DefArt
tsnaidhmlásadóireacht	snaidhmlásadóireacht	Noun:Fem:Com:Sg:DefArt
tsnaidhmlása	snaidhmlása	Noun:Masc:Gen:Sg:DefArt
tsnaidhm	snaidhm	Noun:Fem:Com:Sg:DefArt
tsnabaireacht	snabaireacht	Noun:Fem:Com:Sg:DefArt
tsnabóg	snabóg	Noun:Fem:Com:Sg:DefArt
tsnaba	snab	Noun:Masc:Gen:Sg:DefArt
tsnafaigh	snafach	Noun:Masc:Gen:Sg:DefArt
tsnagaireacht	snagaireacht	Noun:Fem:Com:Sg:DefArt
tsnagaire	snagaire	Noun:Masc:Gen:Sg:DefArt
tsnagaíocht	snagaíocht	Noun:Fem:Com:Sg:DefArt
tsnagaí	snagaí	Noun:Masc:Gen:Sg:DefArt
tsnagbhanna	snagbhanna	Noun:Masc:Gen:Sg:DefArt
tsnagcheoil	snagcheol	Noun:Masc:Gen:Sg:DefArt
tsnaga	snag	Noun:Masc:Gen:Sg:DefArt
tsnamóg	snamóg	Noun:Fem:Com:Sg:DefArt
tsnapáil	snapáil	Noun:Fem:Com:Sg:DefArt
tsnap	snap	Noun:Masc:Gen:Sg:DefArt
tsnasaireacht	snasaireacht	Noun:Fem:Com:Sg:DefArt
tsnasaire	snasaire	Noun:Masc:Gen:Sg:DefArt
tsnasáin	snasán	Noun:Masc:Gen:Sg:DefArt
tsnaschraicinn	snaschraiceann	Noun:Masc:Gen:Sg:DefArt
tsnasleathair	snasleathar	Noun:Masc:Gen:Sg:DefArt
tsnastacht	snastacht	Noun:Fem:Com:Sg:DefArt
tsnasa	snas	Noun:Masc:Gen:Sg:DefArt
tsnaoiseog	snaoiseog	Noun:Fem:Com:Sg:DefArt
tsnaoisín	snaoisín	Noun:Masc:Gen:Sg:DefArt
tsnaoisbhosca	snaoisbhosca	Noun:Masc:Gen:Sg:DefArt
tsnaois	snaois	Noun:Fem:Com:Sg:DefArt
tsnaimh	snamh	Noun:Masc:Gen:Sg:DefArt
tsneaic	sneaic	Noun:Fem:Com:Sg:DefArt
tsneaitsínteacht	sneaitsínteacht	Noun:Fem:Com:Sg:DefArt
tsneaitsín	sneaitsín	Noun:Masc:Gen:Sg:DefArt
tsneachta	sneachta	Noun:Masc:Gen:Sg:DefArt
tsneachtúlacht	sneachtúlacht	Noun:Fem:Com:Sg:DefArt
tsneagaireacht	sneagaireacht	Noun:Fem:Com:Sg:DefArt
tsneagaire	sneagaire	Noun:Masc:Gen:Sg:DefArt
tsneamhaire	sneamhaire	Noun:Masc:Gen:Sg:DefArt
tsneapa	sneap	Noun:Masc:Gen:Sg:DefArt
tsneatair	sneatar	Noun:Masc:Gen:Sg:DefArt
tsneácháin	sneáchán	Noun:Masc:Gen:Sg:DefArt
tsniog	sniog	Noun:Fem:Com:Sg:DefArt
tsniosarnach	sniosarnach	Noun:Fem:Com:Sg:DefArt
tsniotair	sniotar	Noun:Masc:Gen:Sg:DefArt
tsnibire	snibire	Noun:Masc:Gen:Sg:DefArt
tsnib	snib	Noun:Fem:Com:Sg:DefArt
tsnoiteacht	snoiteacht	Noun:Fem:Com:Sg:DefArt
tsnoiteáin	snoiteán	Noun:Masc:Gen:Sg:DefArt
tsnoíodóireacht	snoíodóireacht	Noun:Fem:Com:Sg:DefArt
tsnoíodóra	snoíodóir	Noun:Masc:Gen:Sg:DefArt
tsnoíogair	snoíogar	Noun:Masc:Gen:Sg:DefArt
tsnoí	snoí	Noun:Masc:Gen:Sg:DefArt
tsnoing	snong	Noun:Masc:Gen:Sg:DefArt
tsnua-ungaidh	snua-ungadh	Noun:Masc:Gen:Sg:DefArt
tsnuaphúdair	snuaphúdar	Noun:Masc:Gen:Sg:DefArt
tsnua	snua	Noun:Masc:Gen:Sg:DefArt
tsnáiteoireacht	snáiteoireacht	Noun:Fem:Com:Sg:DefArt
tsnáithe	snáithe	Noun:Fem:Com:Sg:DefArt
tsnáithire	snáithire	Noun:Masc:Gen:Sg:DefArt
tsnáithín	snáithín	Noun:Masc:Gen:Sg:DefArt
tsnámhaíocht	snámhaíocht	Noun:Fem:Com:Sg:DefArt
tsnámhaí	snámhaí	Noun:Masc:Gen:Sg:DefArt
tsnámhacháin	snámhachán	Noun:Masc:Gen:Sg:DefArt
tsnámhacht	snámhacht	Noun:Fem:Com:Sg:DefArt
tsnámháin	snámhán	Noun:Masc:Gen:Sg:DefArt
tsnámhóra	snámhóir	Noun:Masc:Gen:Sg:DefArt
tsnámhbhuacaire	snámhbhuacaire	Noun:Masc:Gen:Sg:DefArt
tsnámhchnaí	snámhchnaí	Noun:Masc:Gen:Sg:DefArt
tsnámhraic	snámhraic	Noun:Fem:Com:Sg:DefArt
tsnámhthitim	snámhthitim	Noun:Fem:Com:Sg:DefArt
tsnámha	snámh	Noun:Masc:Gen:Sg:DefArt
tsnáthaid	snáthaid	Noun:Fem:Com:Sg:DefArt
tsnáthadáin	snáthadán	Noun:Masc:Gen:Sg:DefArt
tsnáthadóra	snáthadóir	Noun:Masc:Gen:Sg:DefArt
tsnátháin	snáthán	Noun:Masc:Gen:Sg:DefArt
tsnáthphéist	snáthphéist	Noun:Fem:Com:Sg:DefArt
tsnátha	snáth	Noun:Masc:Gen:Sg:DefArt
tsníomhaire	sníomhaire	Noun:Masc:Gen:Sg:DefArt
tsníomhaí	sníomhaí	Noun:Masc:Gen:Sg:DefArt
tsníomhacháin	sníomhachán	Noun:Masc:Gen:Sg:DefArt
tsníomhadaíocht	sníomhadaíocht	Noun:Fem:Com:Sg:DefArt
tsníomhadáin	sníomhadán	Noun:Masc:Gen:Sg:DefArt
tsníomha	sníomh	Noun:Masc:Gen:Sg:DefArt
tsnípéara	snípéir	Noun:Masc:Gen:Sg:DefArt
tsní	sní	Noun:Fem:Com:Sg:DefArt
tsnúúlacht	snúúlacht	Noun:Fem:Com:Sg:DefArt
tsnúcair	snúcar	Noun:Masc:Gen:Sg:DefArt
tsnúda	snúda	Noun:Masc:Gen:Sg:DefArt
tsraimín	sraimín	Noun:Masc:Gen:Sg:DefArt
tsraimleog	sraimleog	Noun:Fem:Com:Sg:DefArt
tsraimleáil	sraimleáil	Noun:Fem:Com:Sg:DefArt
tsraimle	sraimle	Noun:Masc:Gen:Sg:DefArt
tsraimlíocht	sraimlíocht	Noun:Fem:Com:Sg:DefArt
tsraithadhmaid	sraithadhmad	Noun:Masc:Gen:Sg:DefArt
tsraithuimhir	sraithuimhir	Noun:Fem:Com:Sg:DefArt
tsraithchomórtais	sraithchomórtas	Noun:Masc:Gen:Sg:DefArt
tsraithchíste	sraithchíste	Noun:Masc:Gen:Sg:DefArt
tsraithchluiche	sraithchluiche	Noun:Masc:Gen:Sg:DefArt
tsraithfhabht	sraithfhabht	Noun:Masc:Gen:Sg:DefArt
tsraithnaisc	sraithnasc	Noun:Masc:Gen:Sg:DefArt
tsraithradhairc	sraithradharc	Noun:Masc:Gen:Sg:DefArt
tsraithrannaithe	sraithrannú	Noun:Masc:Gen:Sg:DefArt
tsraith	sraith	Noun:Fem:Com:Sg:DefArt
tsrac-ancaire	srac-ancaire	Noun:Masc:Gen:Sg:DefArt
tsracaimsir	sracaimsir	Noun:Fem:Com:Sg:DefArt
tsracaireacht	sracaireacht	Noun:Fem:Com:Sg:DefArt
tsracaire	sracaire	Noun:Masc:Gen:Sg:DefArt
tsracadóireacht	sracadóireacht	Noun:Fem:Com:Sg:DefArt
tsracaidh	sracadh	Noun:Masc:Gen:Sg:DefArt
tsraceolais	sraceolas	Noun:Masc:Gen:Sg:DefArt
tsracobair	sracobair	Noun:Fem:Com:Sg:DefArt
tsracuaignis	sracuaigneas	Noun:Masc:Gen:Sg:DefArt
tsracúlacht	sracúlacht	Noun:Fem:Com:Sg:DefArt
tsracfhéachaint	sracfhéachaint	Noun:Fem:Com:Sg:DefArt
tsracléaráid	sracléaráid	Noun:Fem:Com:Sg:DefArt
tsracsháibh	sracshábh	Noun:Masc:Gen:Sg:DefArt
tsracshúil	sracshúil	Noun:Fem:Com:Sg:DefArt
tsramaide	sramaide	Noun:Masc:Gen:Sg:DefArt
tsramaíocht	sramaíocht	Noun:Fem:Com:Sg:DefArt
tsramacháin	sramachán	Noun:Masc:Gen:Sg:DefArt
tsramadais	sramadas	Noun:Masc:Gen:Sg:DefArt
tsramaidh	sramadh	Noun:Masc:Gen:Sg:DefArt
tsrama	srama	Noun:Masc:Gen:Sg:DefArt
tsrama	sram	Noun:Masc:Gen:Sg:DefArt
tsrannaire	srannaire	Noun:Masc:Gen:Sg:DefArt
tsrannáin	srannán	Noun:Masc:Gen:Sg:DefArt
tsrannfach	srannfach	Noun:Fem:Com:Sg:DefArt
tsrann	srann	Noun:Fem:Com:Sg:DefArt
tsrapnail	srapnal	Noun:Masc:Gen:Sg:DefArt
tsrathaireacht	srathaireacht	Noun:Fem:Com:Sg:DefArt
tsrathaire	srathaire	Noun:Masc:Gen:Sg:DefArt
tsrathairt	srathairt	Noun:Fem:Com:Sg:DefArt
tsrathair	srathair	Noun:Fem:Com:Sg:DefArt
tsrathnaithe	srathnú	Noun:Masc:Gen:Sg:DefArt
tsrathróg	srathróg	Noun:Fem:Com:Sg:DefArt
tsratha	srath	Noun:Masc:Gen:Sg:DefArt
tsrathaithe	srathú	Noun:Masc:Gen:Sg:DefArt
tsraoilleachais	sraoilleachas	Noun:Masc:Gen:Sg:DefArt
tsraoilleog	sraoilleog	Noun:Fem:Com:Sg:DefArt
tsraoilleáin	sraoilleán	Noun:Masc:Gen:Sg:DefArt
tsraoillín	sraoillín	Noun:Masc:Gen:Sg:DefArt
tsraoillte	sraoilleadh	Noun:Masc:Gen:Sg:DefArt
tsraoill	sraoill	Noun:Fem:Com:Sg:DefArt
tsraodbhalla	sraodbhalla	Noun:Masc:Gen:Sg:DefArt
tsraoda	sraod	Noun:Masc:Gen:Sg:DefArt
tsraonaire	sraonaire	Noun:Masc:Gen:Sg:DefArt
tsraonaidh	sraonadh	Noun:Masc:Gen:Sg:DefArt
tsraothartach	sraothartach	Noun:Fem:Com:Sg:DefArt
tsraotha	sraoth	Noun:Masc:Gen:Sg:DefArt
tsreabhainn	sreabhann	Noun:Masc:Gen:Sg:DefArt
tsreabháin	sreabhán	Noun:Masc:Gen:Sg:DefArt
tsreabhchláir	sreabhchlár	Noun:Masc:Gen:Sg:DefArt
tsreabhlaigh	sreabhlach	Noun:Masc:Gen:Sg:DefArt
tsreabhlíne	sreabhlíne	Noun:Fem:Com:Sg:DefArt
tsreabh	sreabh	Noun:Fem:Com:Sg:DefArt
tsreang-ghloine	sreang-ghloine	Noun:Fem:Com:Sg:DefArt
tsreangaireacht	sreangaireacht	Noun:Fem:Com:Sg:DefArt
tsreangaire	sreangaire	Noun:Masc:Gen:Sg:DefArt
tsreangadach	sreangadach	Noun:Fem:Com:Sg:DefArt
tsreangadóireacht	sreangadóireacht	Noun:Fem:Com:Sg:DefArt
tsreangadóra	sreangadóir	Noun:Masc:Gen:Sg:DefArt
tsreangáin	sreangán	Noun:Masc:Gen:Sg:DefArt
tsreangbháis	sreangbhás	Noun:Masc:Gen:Sg:DefArt
tsreangscéil	sreangscéal	Noun:Masc:Gen:Sg:DefArt
tsreangshúil	sreangshúil	Noun:Fem:Com:Sg:DefArt
tsreangthomhais	sreangthomhas	Noun:Masc:Gen:Sg:DefArt
tsreangthomhsaire	sreangthomhsaire	Noun:Masc:Gen:Sg:DefArt
tsreangtha	sreangadh	Noun:Masc:Gen:Sg:DefArt
tsreang	sreang	Noun:Fem:Com:Sg:DefArt
tsriabháin	sriabhán	Noun:Masc:Gen:Sg:DefArt
tsriantacht	sriantacht	Noun:Fem:Com:Sg:DefArt
tsriantóra	sriantóir	Noun:Masc:Gen:Sg:DefArt
tsrianta	srianadh	Noun:Masc:Gen:Sg:DefArt
tsriain	srian	Noun:Masc:Gen:Sg:DefArt
tsrincne	srincne	Noun:Fem:Com:Sg:DefArt
tsroighill	sroigheall	Noun:Masc:Gen:Sg:DefArt
tsruithe	sruithe	Noun:Fem:Com:Sg:DefArt
tsruithléinn	sruithléann	Noun:Masc:Gen:Sg:DefArt
tsruáin	sruán	Noun:Masc:Gen:Sg:DefArt
tsrubh	srubh	Noun:Fem:Com:Sg:DefArt
tsruthaire	sruthaire	Noun:Masc:Gen:Sg:DefArt
tsrutharlaithe	srutharlú	Noun:Masc:Gen:Sg:DefArt
tsrutheolais	srutheolas	Noun:Masc:Gen:Sg:DefArt
tsrutháin	sruthán	Noun:Masc:Gen:Sg:DefArt
tsruthbhailbhe	sruthbhailbhe	Noun:Fem:Com:Sg:DefArt
tsruthchúrsa	sruthchúrsa	Noun:Masc:Gen:Sg:DefArt
tsruthghainimh	sruthghaineamh	Noun:Masc:Gen:Sg:DefArt
tsruthlaigh	sruthlach	Noun:Masc:Gen:Sg:DefArt
tsruthlaim	sruthlam	Noun:Masc:Gen:Sg:DefArt
tsruthligin	sruthligean	Noun:Masc:Gen:Sg:DefArt
tsruthlinn	sruthlinn	Noun:Fem:Com:Sg:DefArt
tsruthláin	sruthlán	Noun:Masc:Gen:Sg:DefArt
tsruthlíne	sruthlíne	Noun:Fem:Com:Sg:DefArt
tsruthlín	sruthlíon	Noun:Masc:Gen:Sg:DefArt
tsruthlaithe	sruthlú	Noun:Masc:Gen:Sg:DefArt
tsruthmhachnaimh	sruthmhachnamh	Noun:Masc:Gen:Sg:DefArt
tsruthmheabhair	sruthmheabhair	Noun:Fem:Com:Sg:DefArt
tsruthmheátáin	sruthmheátán	Noun:Masc:Gen:Sg:DefArt
tsruthshoilseacht	sruthshoilseacht	Noun:Fem:Com:Sg:DefArt
tsruthshoilsithe	sruthshoilsiú	Noun:Masc:Gen:Sg:DefArt
tsrutha	sruth	Noun:Masc:Gen:Sg:DefArt
tsráideoireacht	sráideoireacht	Noun:Fem:Com:Sg:DefArt
tsráideog	sráideog	Noun:Fem:Com:Sg:DefArt
tsráideánaigh	sráideánach	Noun:Masc:Gen:Sg:DefArt
tsráidéigis	sráidéigeas	Noun:Masc:Gen:Sg:DefArt
tsráidín	sráidín	Noun:Masc:Gen:Sg:DefArt
tsráidí	sráidí	Noun:Masc:Gen:Sg:DefArt
tsráidbhaile	sráidbhaile	Noun:Masc:Gen:Sg:DefArt
tsráid	sráid	Noun:Fem:Com:Sg:DefArt
tsráilleog	sráilleog	Noun:Fem:Com:Sg:DefArt
tsráin	srán	Noun:Masc:Gen:Sg:DefArt
tsréamlóg	sréamlóg	Noun:Fem:Com:Sg:DefArt
tsríobúin	sríobún	Noun:Masc:Gen:Sg:DefArt
tsríoc	sríoc	Noun:Fem:Com:Sg:DefArt
tsróinínteacht	sróinínteacht	Noun:Fem:Com:Sg:DefArt
tsróinín	sróinín	Noun:Masc:Gen:Sg:DefArt
tsróladhmaid	sróladhmad	Noun:Masc:Gen:Sg:DefArt
tsrónaíl	srónaíl	Noun:Fem:Com:Sg:DefArt
tsrónacánacht	srónacánacht	Noun:Fem:Com:Sg:DefArt
tsrónaigh	srónach	Noun:Masc:Gen:Sg:DefArt
tsrónbheannaigh	srónbheannach	Noun:Masc:Gen:Sg:DefArt
tsrónbhirt	srónbheart	Noun:Masc:Gen:Sg:DefArt
tsrónchuais	srónchuas	Noun:Masc:Gen:Sg:DefArt
tsrónchreasa	srónchrios	Noun:Masc:Gen:Sg:DefArt
tsrónmhúchta	srónmhúchadh	Noun:Masc:Gen:Sg:DefArt
tsrón	srón	Noun:Fem:Com:Sg:DefArt
tsróil	sról	Noun:Masc:Gen:Sg:DefArt
tsrúill	srúill	Noun:Fem:Com:Sg:DefArt
tsrúmáil	srúmáil	Noun:Fem:Com:Sg:DefArt
tsrúmálaí	srúmálaí	Noun:Masc:Gen:Sg:DefArt
tsrúsraim	srúsram	Noun:Masc:Gen:Sg:DefArt
tsrúib	srúb	Noun:Masc:Gen:Sg:DefArt
tsanta	sannadh	Noun:Masc:Gen:Sg:DefArt
tsic	seac	Noun:Masc:Gen:Sg:DefArt
tsirbh	searbh	Noun:Masc:Gen:Sg:DefArt
tsirg	searg	Noun:Masc:Gen:Sg:DefArt
tsínidh	síneadh	Noun:Masc:Gen:Sg:DefArt
tsaighean	saighean	Noun:Fem:Com:Sg:DefArt
