Moses=Maois
Aristotle=Arastotail
Plato=Platón
Socrates=Sócraitéas
Ptolemy=Tolamaes
Hippocrates=Hipeacraitéas
Cicero=Cicearó
Plutarch=Plútarc
Epicurus=Eipiciúras
Archimedes=Airciméidéas
Pythagoras=Píotágarás
Boethius=Bóétias
Sisyphus=Siosafas
Vishnu=Visniú
Shiva=Síve
Aeneas=Aenéas
Aesop=Aesóp
Damocles=Dámaicléas
Judas=Iúdás
Loki=Láca
Kali=Cailí
Hera=Héara|Héire
Polyphemus=Polaiféamas
Khentika=Ceintice
Dido=Díodó
Cerberus=Ceirbearas
Eurytus=Eoratas
Hercules=Earcail|Heirciléas
Pope=Pápa
Odysseus=Odaiséas
Eurytion=Eoratón
Jehovah=Iehova
Yahweh=Iáivé
Demeter=Déiméatar
Pegasus=Peigeasas
Proteus=Próitéas
Ossian=Oisín
Juno=Iúnó
Cleito=Cléató
Mohammad=Mahamad
Lucifer=Lúicifir
Theseus=Téiséas
Antaeus|Antæus=Antaes
