# Adjectives and usually confused associated nouns
# List retrieved and triaged from AfterTheDeadline
# Extends A_INFINITIVE with appropriate suggestions
#
abrupt=abruptness
aggressive=aggressiveness
angry=anger
attentive=attentiveness
aware=awareness
awkward=awkwardness
beautiful=beauty
bitter=bitterness
bland=blandness
brave=bravery
brief=briefness
bright=brightness
busy=business
careless=carelessness
casual=casually
cheerful=cheerfulness
childish=child
cleanl=cleanliness
clever=cleverness
conscious=consciousness
correct=correctness
crafty=craftiness
crazy=craziness
crazy=craziness
dangerous=danger
dark=darkness
easy=ease
empty=emptiness
expressive=expression
eyewit=eyewitness
faithful=faithfulness
familiar=familiarity
fast=fastness
fearless=fearlessness
fierce=fierceness
fiery=fieriness
firm=firmness
foamy=foaminess
fresh=freshness
fruitful=fruitfulness
funny=funniness
generous=generousness
gentle=gentleness
genuine=genuineness
gloomy=gloominess
good=goodness
gracious=graciousness
grateful=gratefulness
greasy=greasiness
great=greatness
greedy=greediness
grouchy=grouchiness
guilty=guilt
happy=happiness
hard=hardness
haughty=haughtiness
healthy=healthiness
humble=humbleness
hungry=hungriness
ill=illness
incorrect=incorrectness
indebted=indebtedness
intelligent=intelligence
juicy=juice
# kind=kindness
late=lateness
lonely=loneliness
lucky=luck
manly=manliness
massive=massiveness
miserable=misery
natural=nature
offensive=offence
painful=pain
prompt=promptness
queasy=queasiness
questionable=question
quick=quickness
rash=rashness
righteous=righteousness
romantic=romance
round=roundness
sad=sadness
scary=scariness
shy=shyness
sick=sickness
smooth=smoothness
spacious=spaciousness
squeamish=squeamishness
strong=strength
stubborn=stubbornness
tardy=tardiness
true=truth
ugly=ugliness
violent=violence
warm=warmth
weak=weakness
windy=wind
witty=wit
wretched=wretchedness
young=youth
zealous=zeal

