# Colloquial expressions
# Copyright (C) 2019 Tiago Santos (http://https://github.com/TiagoSantos81)
# https://en.wiktionary.org/wiki/Category:English_informal_terms
#
agonisin'=agonising
agonizin'=agonizing
ain’t=am not|are not|is not
ain’t=has not|have not
all righto=all right
all righty=all right
alotta=a lot of
alright?=is everything all right with you?
anythin'=anything
a one off=a one time event
a piece of cake=very easy
awfy=awful
aye=yes
babez=girls
back on her feet=recover
back on his feet=recover
back on my feet=recover
back on your feet=recover
ball and chain=wife|spouse
balls up=messed up
barmy=crazy|insane
beastly=nasty|unpleasant
becoz=because
beggar off=go away
betcha=bet you
bladdered=extremely drunk
blingy=shiny|sparkly
blinkered=narrow minded
bloke=man
b'long=belong
bollocks=rubbish|no good
'bortion=abortion
# bravo=well done|congratulations
bromance=great friendship
bugger all=very little|nothing
call it a day=stop
chalk and cheese=not fitted
chap=gentleman
chat up=flirt
cheers=thank you|regards
chopstix=chopsticks
cmon=come on
cock up=mistake|failure
compuper=computer
cos=because
cougar=attractive middle aged woman
coulda=could have
crack on=start|continue
crikey=[OMIT IF POSSIBLE]
cuppa=cup of
daft=silly|stupid
dapper=well dressed|well to-do
didntcha=didn’t you
dija=did you
dime a dozen=very common|lots
dodgy=untrustworthy|dysfunctional
do-lally=mentally insane
dontcha=don’t you
drama queen=overly emotional
dunno=don’t know
d’you=do you
# easy now=calm down|be gentle
fall short=are not enough
falls short=is not enough
fell short=were not enough
fishin'=fishing
fiver=five pounds
flippin’=[omit]
foxy lady=attractive lady
freaked out=panicked
freaking out=panicking
freak out=panick
# gawp=stare
geaux=go
geezer=man
gimme=give me
girlz=girls
gnashers=teeth
God bless u=God bless you
gonna=going to
gormless=unintelligent
gotcha=got you
gotta=got a
gotta=got to
grub=food
# gutted=extremely disappointed|extremely upset
hafta=have to
hasta=has to
Her Majesty’s pleasure=life imprisonment
hi=hello|how are you
hitz=hits
# Hollyweird=
# homeboi=
hottie=attractive female
i’mma=i’m going to
innit?=isn’t it?
it's a piece of cake=it's very easy
jolly good=very good
# Joo=jewish
# jump the couch=lose control|go crazy
# jus'=just
keep a straight face=keep from laughing
kiddin'=joking
kidz=kids
kinda=kind of
knackered=exhausted|tired
kno=know
knockers=breasts
l8ly=lately
ladies and gents=ladies and gentlemen
layder=later
lemme=let me
lighten up a bit=relax
lite=light
# lo= EXC lo and behold
lol=laughing
loony=insane
loopy=insane
# lost the plot=gone crazy
lotsa=lots of
lovely-jubbly=lovely
lovez=loves
# m80=matey
meh!=who cares?
Merdoch=Murdoch
mighta=might have
mightna=mightn’t have
mucha=much of
mudslum=muslim
mufti=non-uniform clothing
mussna=must not have
musta=must have
na=no
needa=need to
# New York Shitty=
nicked=stolen
nite=night
'nough=enough
# nuts=crazy
o' course=of course
oughta=ought to
outta=out of
paper mache=papier-mâché
# phuqing=
pissed off=angry
# Pokemon=
posh=high class|sophisticated
prat=unintelligent|troublemaker
puke=vomit
pukka=excellent
# qool=
# qrazy=
# quid=one pound
# qyoot=
# rite=
rubs me the wrong way=bothers me
rubs the wrong way=bothers
rub the wrong way=bother
# rulez=rules
she’da=she would have
shoulda=should have
shouldna=shouldn’t have
s’more=some more
some1=someone
somethin'=something
sorta=sort of
soshulist=socialist
str8=straight
supposta=supposed to
take a load off=relax
takes the piss=mocks
take the piss=mock
taking the piss=mocking
ta=thank you
tat=tattoo
tell’em=tell them
tenner=ten pounds
thanQ=thank you
# thaz=
# thin'=
# thoro=
took the piss=mocked
uni=university
up for grabs=available
up for it=eager
usta=used to
vidgame=videogame
wanna=want a
wanna=want to
whatcha=what are you
whatcha=what have you
# whaz=
wicked=evil|cool|exciting
wimen=women
# winds up=annoys
# wind up=annoy
wontcha=won’t you
woulda=would have
wouldna=wouldn’t have
wrap this up=finish
xbow=crossbow
XQs=excuse
xword puzzle=crossword puzzle
ya=you|you are

