# Verb and usually confused associated nouns
# List retrieved and triaged from AfterTheDeadline
# Extends A_INFINITIVE with appropriate suggestions
#
abate=abatement
abates=abatements
abduct=abduction
abducts=abductions
abide=observance
abides=observances
abolish=abolition
abolishs=abolitions
abominate=abomination
abominates=abominations
abort=abortion
aborts=abortions
absorb=absorption
absorbs=absorptions
accelerate=acceleration
accelerates=accelerations
accept=acceptance
accepts=acceptances
# accept=reception
# accepts=receptions
accommodate=accommodation
accommodates=accommodations
accompany=accompaniment
accompanies=accompaniments
accomplish=accomplishment
accomplishs=accomplishments
accumulate=accumulation
accumulates=accumulations
accuse=accusation
accuses=accusations
achieve=achievement
achieves=achievements
acknowledge=acknowledgement
acknowledges=acknowledgements
acquire=acquisition
acquires=acquisitions
adapt=adaptation
adapts=adaptations
# adapt=adapting
# adapts=adaptings
# adapt=dramatization
# adapts=dramatizations
add=addition
adds=additions
adjust=adjustment
adjusts=adjustments
# adjust=readjustment
# adjusts=readjustments
administer=administration
administers=administrations
admit=admission
admits=admissions
admonish=admonition
admonishs=admonitions
adopt=adoption
adopts=adoptions
advertise=advertisement
advertises=advertisements
# advertise=advertising
# advertises=advertisings
advise=advice
advises=advices
affirm=affirmation
affirms=affirmations
afflict=affliction
afflicts=afflictions
afford=affordability
affords=affordabilities
agitate=agitation
agitates=agitations
# agree=accordance
# agrees=accordances
agree=agreement
agrees=agreements
# agree=assent
# agrees=assents
# agree=covenant
# agrees=covenants
# agree=understanding
# agrees=understandings
alienate=disaffection
alienates=disaffections
allege=allegation
alleges=allegations
allocate=allocation
allocates=allocations
allow=allowance
allows=allowances
allude=allusion
alludes=allusions
alternate=alternative
alternates=alternatives
amalgamate=amalgamation
amalgamates=amalgamations
amend=amendment
amends=amendments
announce=announcement
announces=announcements
annoy=nuisance
annoies=nuisances
anticipate=anticipation
anticipates=anticipations
appear=appearance
appears=appearances
# appear=illusion
# appears=illusions
# appear=semblance
# appears=semblances
applaud=ovation
applauds=ovations
# apply=applicability
# applies=applicabilities
# apply=applicant
# applies=applicants
apply=application
applies=applications
appoint=appointment
appoints=appointments
# appoint=confirmation
# appoints=confirmations
# appoint=swearing
# appoints=swearings
appreciate=appreciation
appreciates=appreciations
approve=clearance
approves=clearances
arbitrate=arbitration
arbitrates=arbitrations
argue=argument
argues=arguments
# argue=confrontation
# argues=confrontations
# argue=friction
# argues=frictions
# argue=incompatibility
# argues=incompatibilities
# argue=squabbling
# argues=squabblings
# argue=tension
# argues=tensions
ascend=ascent
ascends=ascents
assail=assailant
assails=assailants
assassinate=assassination
assassinates=assassinations
assert=assertion
asserts=assertions
assess=assessment
assesses=assessments
# assist=assistant
# assists=assistants
assume=assumption
assumes=assumptions
assure=assurance
assures=assurances
# assure=confidence
# assures=confidences
astonish=astonishment
astonishs=astonishments
attach=attachment
attachs=attachments
attend=attendance
attends=attendances
# attend=attendant
# attends=attendants
# attend=attention
# attends=attentions
attract=attraction
attracts=attractions
authorize=authority
authorizes=authorities
# authorize=authorization
# authorise=authorisation
# authorizes=authorizations
# authorises=authorisations
# authorize=reauthorization
# authorise=reauthorisation
# authorizes=reauthorizations
# authorises=reauthorisations
automate=automation
automates=automations
avenge=vengeance
avenges=vengeances
avoid=avoidance
avoids=avoidances
bathe=bath
bathes=baths
begin=beginning
begins=beginnings
# begin=inception
# begins=inceptions
# begin=infancy
# begins=infancies
befriend=friend
befriends=friends
behave=behaviour
behaves=behaviours
#behave=bearing
#behaves=bearings
# behave=conscience
# behaves=consciences
# behave=fashion
# behaves=fashions
# behave=performance
# behaves=performances
# behave=whoring
# behaves=whorings
behead=beheading
beheads=beheadings
benumb=numb
benumbs=numbs
beseige=siege
bedieges=sieges
believe=belief
believes=beliefs
# believe=conviction
# believes=convictions
# believe=delusion
# believes=delusions
# believe=misperception
# believes=misperceptions
# believe=perception
# believes=perceptions
bleed=blood
bleeds=bloods
bleed=bleeding
bleeds=bleedings
bless=blessing
blesses=blessings
bombard=bombardment
bombards=bombardments
breathe=breathing
breathes=breathings
breathe=breath
breathes=breaths
bring=bringing
brings=bringings
broaden=globalization
broadens=globalizations
calculate=calculation
calculates=calculations
capitalize=capitalization
capitalise=capitalisation
capitalizes=capitalizations
capitalises=capitalisations
# capitalize=recapitalization
# capitalise=recapitalisation
# capitalizes=recapitalizations
# capitalises=recapitalisations
catalyze=agent
catalyzes=agents
celebrate=celebration
celebrates=celebrations
# celebrate=function
# celebrates=functions
# celebrate=reception
# celebrates=receptions
characterize=characterization
characterise=characterisation
characterizes=characterizations
characterises=characterisations
choose=choosing
chooses=choosings
circulate=circulation
circulates=circulations
clarify=clarification
clarifies=clarifications
classify=classification
classifies=classifications
clothe=cloth
# clothes=cloths also a noun
coerce=coercion
coerces=coercions
coincide=coincidence
coincides=coincidences
come=descent
comes=descents
# come=homecoming
# comes=homecomings
commemorate=festivity
commemorates=festivities
commence=commencement
commences=commencements
commercialize=commercialization
commercialise=commercialisation
commercializes=commercializations
commercialises=commercialisations
communicate=communication
communicates=communications
compensate=compensation
compensates=compensations
compete=competition
competes=competitions
# compete=jockeying
# competes=jockeyings
# compete=tournament
# competes=tournaments
compile=compilation
compiles=compilations
complain=grievance
complains=grievances
complicate=complication
complicates=complications
comply=compliance
complies=compliances
compose=composition
composes=compositions
comprehend=comprehension
comprehends=comprehensions
compute=computing
computes=computings
conceive=conception
conceives=conceptions
conclude=conclusion
concludes=conclusions
concoct=concoction
concocts=concoctions
concur=concurrence
concurs=concurrences
condemn=condemnation
condemns=condemnations
confess=confession
confesses=confessions
confide=confidant
confides=confidants
confirm=confirmation
confirms=confirmations
confuse=confusion
confuses=confusions
# confuse=discombobulation
# confuses=discombobulations
conquer=repression
conquers=repressions
consider=consideration
considers=considerations
consolidate=consolidation
consolidates=consolidations
construe=construction
construes=constructions
consume=consuming
consumes=consumings
# consume=consumption
# consumes=consumptions
# contain=containment
# contains=containments
contain=content
contains=contents
contaminate=contamination
contaminates=contaminations
# contaminate=corruption
# contaminates=corruptions
# contaminate=debasement
# contaminates=debasements
# contaminate=perversion
# contaminates=perversions
contend=contention
contends=contentions
continue=continuation
continues=continuations
contradict=contradiction
contradicts=contradictions
contribute=contribution
contributes=contributions
cooperate=cooperation
cooperates=cooperations
correspond=correspondence
corresponds=correspondences
crave=craving
craves=cravings
create=creation
creates=creations
culminate=culmination
culminates=culminations
cultivate=cultivation
cultivates=cultivations
deactivate=inactivation
deactivates=inactivations
# deactivate=mothballing
# deactivates=mothballings
deceive=deception
deceives=deceptions
decentralize=decentralization
decentralise=decentralisation
decentralizes=decentralizations
decentralises=decentralisations
decide=decision
decides=decisions
declare=declaration
declares=declarations
decorate=decoration
decorates=decorations
dedicate=dedication
dedicates=dedications
deduct=deductibility
deducts=deductibilities
defend=defence
defends=defences
# defend=battlement
# defends=battlements
# defend=defendant
# defends=defendants
defer=deference
defers=deferences
define=definition
defines=definitions
defy=defiance
defies=defiances
delete=deletion
deletes=deletions
delve=delving
delves=delvings
demonstrate=demonstration
demonstrates=demonstrations
denominate=denomination
denominates=denominations
depend=dependence
depends=dependences
# depend=dependent
# depends=dependents
# depend=independence
# depends=independences
# depend=overdependence
# depends=overdependences
depict=depiction
depicts=depictions
deplete=depletion
depletes=depletions
deploy=deployment
deploies=deployments
deport=deportation
deports=deportations
depreciate=depreciation
depreciates=depreciations
depress=depressant
depresses=depressants
# depress=depression
# depresses=depressions
deprive=deprivation
deprives=deprivations
deregulate=deregulation
deregulates=deregulations
deride=derision
derides=derisions
# descend=descendant
# descends=descendant
descend=descent
descends=descents
describe=description
describes=descriptions
designate=designation
designates=designations
destine=destination
destines=destinations
destroy=destruction
destroies=destructions
detain=detention
detains=detentions
deter=deterrence
deters=deterrences
# deter=deterrent
# deters=deterrents
deteriorate=deterioration
deteriorates=deteriorations
determine=determination
determines=determinations
devastate=devastation
devastates=devastations
develop=developing
develops=developings
# develop=development
# develops=developments
devote=devotion
devotes=devotions
# differ=commonality
# differs=commonalities
# differ=compatibility
# differs=compatibilities
differ=difference
differs=differences
# differ=discrepancy
# differs=discrepancies
# differ=disparity
# differs=disparities
# differ=similarity
# differs=similarities
diminish=diminution
diminishs=diminutions
# disagree=contention
# disagrees=contentions
disagree=disagreement
disagrees=disagreements
disappear=disappearance
disappears=disappearances
# disappear=oblivion
# disappears=oblivions
disappoint=disappointment
disappoints=disappointments
disassociate=disaffiliation
disassociates=disaffiliations
disband=disbanding
disbands=disbandings
disburse=disbursement
disburses=disbursements
discontinue=discontinuation
discontinues=discontinuations
discourage=discouragement
discourages=discouragements
discriminate=discrimination
discriminates=discriminations
# discuss=conversation
# discusses=conversations
discuss=discussion
discusses=discussions
disgorge=disgorgement
disgorges=disgorgements
disintegrate=disintegration
disintegrates=disintegrations
disobey=disobedience
disobeys=disobediences
# disparage=aspersion
# disparages=aspersions
disparage=derogation
disparages=derogations
displace=displacing
displaces=displacings
dispose=disposition
disposes=dispositions
disqualify=disqualification
disqualifies=disqualifications
# disrupt=convulsion
# disrupts=convulsions
# disrupt=dislocation
# disrupts=dislocations
disrupt=disruption
disrupts=disruptions
dissatisfy=dissatisfaction
dissatisfies=dissatisfactions
dissect=dissection
dissects=dissections
disseminate=dissemination
disseminates=disseminations
# dissent=dissident-dissent
# dissents=dissident-dissents
dissolve=dissolution
dissolves=dissolutions
distinguish=distinction
distinguishs=distinctions
distort=distortion
distorts=distortions
distract=distraction
distracts=distractions
distribute=distribution
distributes=distributions
# disturb=commotion
# disturbs=commotions
disturb=disturbance
disturbs=disturbances
diverge=divergence
diverges=divergences
diversify=diversification
diversifies=diversifications
divert=diversion
diverts=diversions
# do=fling
# does=flings
dominate=dominance
dominates=dominances
# dominate=domination
# dominates=dominations
# dominate=dominion
# dominates=dominions
# dominate=jurisdiction
# dominates=jurisdictions
donate=donation
donates=donations
do=wrongdoing.
dos=wrongdoing.s
dwell=dwelling
dwells=dwellings
earn=earning
earns=earnings
# earn=pension
# earns=pensions
eavesdrop=eavesdropping
eavesdrops=eavesdroppings
educate=education
educates=educations
# educate=eduction
# educates=eductions
eliminate=elimination
eliminates=eliminations
emasculate=emasculation
emasculates=emasculations
embarrass=embarrassment
embarrasses=embarrassments
embezzle=embezzlement
embezzles=embezzlements
embody=personification
embodies=personifications
emerge=emergence
emerges=emergences
emigrate=emigration
emigrates=emigrations
emit=emission
emits=emissions
# emit=radiation
# emits=radiations
enact=enactment
enacts=enactments
encourage=encouragement
encourages=encouragements
endanger=endangerment
endangers=endangerments
endorse=endorsement
endorses=endorsements
endow=endowment
endows=endowments
enforce=enforcement
enforces=enforcements
enhance=enhancement
enhances=enhancements
enjoy=enjoyment
enjoies=enjoyments
enlarge=engorgement
enlarges=engorgements
enlighten=enlightenment
enlightens=enlightenments
enroll=enrollment
enrolls=enrollments
enter=entrance
enters=entrances
# enter=entrant
# enters=entrants
entertain=entertainment
entertains=entertainments
entitle=entitlement
entitles=entitlements
entrench=entrenchment
entrenchs=entrenchments
equip=equipment
equips=equipments
erode=erosion
erodes=erosions
err=irregularity
errs=irregularities
# err=misconception
# errs=misconceptions
erupt=eruption
erupts=eruptions
escalate=escalation
escalates=escalations
establish=establishment
establishs=establishments
# establish=grounding
# establishs=groundings
evacuate=evacuation
evacuates=evacuations
evade=evasion
evades=evasions
# evaluate=devaluation
# evaluates=devaluations
evaluate=evaluation
evaluates=evaluations
evaporate=evaporation
evaporates=evaporations
evolve=evolution
evolves=evolutions
examine=examination
examines=examinations
excel=excellence
excels=excellences
excite=excitement
excites=excitements
exclude=exclusion
excludes=exclusions
execute=execution
executes=executions
exist=existence
exists=existences
# exist=presence
# exists=presences
# exist=renaissance
# exists=renaissances
# exist=resurgence
# exists=resurgences
expand=expansion
expands=expansions
expect=expectancy
expects=expectancies
# expect=expectation
# expects=expectations
expel=explusion
expels=explusions
expire=expiration
expires=expirations
explain=explanation
explains=explanations
# explode=combustion
# explodes=combustions
explode=explosion
explodes=explosions
explore=exploration
explores=explorations
extend=extension
extends=extensions
# extend=extent
# extends=extents
extort=extortion
extorts=extortions
extradite=extradition
extradites=extraditions
fabricate=fabrication
fabricates=fabrications
familiarize=familiarization
familiarise=familiarisation
familiarizes=familiarizations
familiarises=familiarisations
# feel=feeling
# feels=feelings
fertilize=fertilization
fertilise=fertilisation
fertilizes=fertilizations
fertilises=fertilisations
fluctuate=fluctuation
fluctuates=fluctuations
formulate=formulation
formulates=formulations
found=foundation
founds=foundations
# found=founding
# founds=foundings
frustrate=frustration
frustrates=frustrations
generalize=generalization
generalise=generalisation
generalizes=generalizations
generalises=generalisations
# generate=cogeneration
# generates=cogenerations
# generate=generating
# generates=generatings
generate=generation
generates=generations
# govern=governance
# governs=governances
# govern=governing
# governs=governings
govern=government
governs=governments
grow=growing
grows=growings
gyrate=gyration
gyrates=gyrations
# happen=event
# happens=events
# happen=fruition
# happens=fruitions
halve=half
# halves=halfs
happen=happening
happens=happenings
# happen=incident
# happens=incidents
harass=harassment
harasses=harassments
# harass=oppression
# harasses=oppressions
heal=healing
heals=healings
hear=rehearing
hears=rehearings
hear=ear
hears=ears
heared=eared
hesitate=hesitation
hesitates=hesitations
# hesitate=reluctance
# hesitates=reluctances
hospitalize=hospitalization
hospitalise=hospitalisation
hospitalizes=hospitalizations
hospitalises=hospitalisations
identify=identification
identifies=identifications
ignore=inattention
ignores=inattentions
illustrate=illustration
illustrates=illustrations
imagine=imagination
imagines=imaginations
imitate=imitation
imitates=imitations
immigrate=immigrant
immigrates=immigrants
# immigrate=immigration
# immigrates=immigrations
impair=impairment
impairs=impairments
impeach=impeachment
impeachs=impeachments
impede=impediment
impedes=impediments
implicate=implication
implicates=implications
impose=imposition
imposes=impositions
# impose=sanction
# imposes=sanctions
imprison=imprisonment
imprisons=imprisonments
improve=improvement
improves=improvements
improvise=improvisation
improvises=improvisations
inaugurate=inauguration
inaugurates=inaugurations
include=inclusion
includes=inclusions
incriminate=incrimination
incriminates=incriminations
incur=incursion
incurs=incursions
indicate=indication
indicates=indications
indict=indictment
indicts=indictments
induce=inducement
induces=inducements
indulge=indulgence
indulges=indulgences
industrialize=industrialization
industrialise=industrialisation
industrializes=industrializations
industrialises=industrialisations
infect=infection
infects=infections
infer=inference
infers=inferences
inflate=inflation
inflates=inflations
inform=information
informs=informations
# inform=intelligence
# informs=intelligences
infringe=infringement
infringes=infringements
ingest=ingestion
ingests=ingestions
inhabit=housing
inhabits=housings
inherit=inheritance
inherits=inheritances
innovate=innovation
innovates=innovations
insist=insistence
insists=insistences
inspect=inspection
inspects=inspections
inspire=inspiration
inspires=inspirations
# inspire=intoxication
# inspires=intoxications
install=installation
installs=installations
instruct=instruction
instructs=instructions
insulate=insulation
insulates=insulations
insure=insurance
insures=insurances
# insure=reinsurance
# insures=reinsurances
integrate=integration
integrates=integrations
intend=intent
intends=intents
# intend=intention
# intends=intentions
interfere=interference
interferes=interferences
interpret=interpretation
interprets=interpretations
# interpret=reinterpretation
# interprets=reinterpretations
# interrogate=deposition
# interrogates=depositions
interrogate=interrogation
interrogates=interrogations
# intervene=interdiction
# intervenes=interdictions
intervene=intervention
intervenes=interventions
intimidate=intimidation
intimidates=intimidations
intone=intonation
intones=intonations
introduce=introduction
introduces=introductions
intrude=intrusion
intrudes=intrusions
invade=invasion
invades=invasions
invent=invention
invents=inventions
# invent=masterminding
# invents=mastermindings
investigate=investigation
investigates=investigations
invest=investing
invests=investings
# invest=investment
# invests=investments
# invest=reinvestment
# invests=reinvestments
involve=involvement
involves=involvements
irradiate=irradiation
irradiates=irradiations
irritate=irritation
irritates=irritations
isolate=isolation
isolates=isolations
# isolate=seclusion
# isolates=seclusions
justify=justification
justifies=justifications
launder=laundering
launders=launderings
legalize=legalization
legalise=legalisation
legalizes=legalizations
legalises=legalisations
lend=lending
lends=lendings
liberalize=liberalization
liberalise=liberalisation
liberalizes=liberalizations
liberalises=liberalisations
liberate=liberation
liberates=liberations
liquidate=liquidation
liquidates=liquidations
loathe=loath
lose=loss
loses=losses
# loath is actually an adjective
locate=location
locates=locations
maintain=maintainence
maintains=maintainences
manipulate=manipulation
manipulates=manipulations
marry=marriage
marries=marriages
migrate=migration
migrates=migrations
miscalculate=miscalculation
miscalculates=miscalculations
misrepresent=misrepresentation
misrepresents=misrepresentations
misstate=misstatement
misstates=misstatements
mitigate=mitigation
mitigates=mitigations
mobilize=mobilization
mobilise=mobilisation
mobilizes=mobilizations
mobilises=mobilisations
modernize=modernization
modernise=modernisation
modernizes=modernizations
modernises=modernisations
modify=modification
modifies=modifications
motivate=motivation
motivates=motivations
mutate=mutation
mutates=mutations
nationalize=nationalization
nationalise=nationalisation
nationalizes=nationalizations
nationalises=nationalisations
navigate=navigation
navigates=navigations
negotiate=negotiation
negotiates=negotiations
neutralize=neutralization
neutralise=neutralisation
neutralizes=neutralizations
neutralises=neutralisations
nominate=nomination
nominates=nominations
notify=notification
notifies=notifications
# obey=bidding
# obeys=biddings
obey=obedience
obeys=obediences
# obey=obeisance
# obeys=obeisances
obfuscate=obfuscation
obfuscates=obfuscations
oblige=obligation
obliges=obligations
# observe=audience
# observes=audiences
observe=observation
observes=observations
obsess=obsession
obsesses=obsessions
obstruct=obstruction
obstructs=obstructions
obtain=availability
obtains=availabilities
# occupy=occupancy
# occupies=occupancies
# occupy=occupant
# occupies=occupants
occupy=occupation
occupies=occupations
# occur=incidence
# occurs=incidences
occur=occurrence
occurs=occurrences
omit=omission
omits=omissions
operate=operating
operates=operatings
# operate=operation
# operates=operations
opine=opinion
opines=opinions
# opine=persuasion
# opines=persuasions
# opine=sentiment
# opines=sentiments
oppose=opponent
opposes=opponents
# oppose=opposition
# opposes=oppositions
oppress=oppression
oppresses=oppressions
opt=option
opts=options
optimise=optimisation
optimises=optimisations
optimize=optimization
optimizes=optimizations
organize=organizing
organise=organising
organizes=organizings
organises=organisings
originate=origination
originates=originations
overstate=overstatement
overstates=overstatements
participate=participant
participates=participants
# participate=participation
# participates=participations
# peddle=pedal
# peddles=pedals
perceive=perception
perceives=perceptions
perform=performance
performs=performances
persecute=persecution
persecutes=persecutions
persist=persistence
persists=persistences
pollinate=pollination
pollinates=pollinations
pollute=pollutant
pollutes=pollutants
# pollute=pollution
# pollutes=pollutions
possess=possession
possesses=possessions
postpone=postponement
postpones=postponements
precede=antecedent
precedes=antecedents
# predict=advent
# predicts=advents
predict=prediction
predicts=predictions
prefer=predilection
prefers=predilections
# prefer=preference
# prefers=preferences
preoccupy=preoccupation
preoccupies=preoccupations
# prepare=precaution
# prepares=precautions
prepare=preparation
prepares=preparations
# prepare=tooling
# prepares=toolings
prepay=prepayment
prepaies=prepayments
prescribe=prescription
prescribes=prescriptions
presume=presumption
presumes=presumptions
prevent=prevention
prevents=preventions
privatize=privatization
privatise=privatisation
privatizes=privatizations
privatises=privatisations
proclaim=proclamation
proclaims=proclamations
profess=profession
professes=professions
prohibit=prohibition
prohibits=prohibitions
proliferate=proliferation
proliferates=proliferations
# promote=hyping
# promotes=hypings
promote=promotion
promotes=promotions
pronounce=pronunciation
pronounces=pronunciations
propose=proposition
proposes=propositions
prosecute=prosecution
prosecutes=prosecutions
prosper=prosperity
prospers=prosperities
# protect=bastion
# protects=bastions
# protect=lotion
# protects=lotions
protect=protection
protects=protections
# protect=safekeeping
# protects=safekeepings
provide=provision
provides=provisions
provoke=provocation
provokes=provocations
publish=publication
publishs=publications
# publish=publishing
# publishs=publishings
pummel=pummeling
pummels=pummelings
# punish=probation
# punishs=probations
punish=punishment
punishs=punishments
# purify=detoxification
# purifies=detoxifications
purify=purification
purifies=purifications
# pursue=pursuing
# pursues=pursuings
pursue=pursuit
pursues=pursuits
qualify=qualification
qualifies=qualifications
quantify=quantification
quantifies=quantifications
ratify=ratification
ratifies=ratifications
rationalize=rationalization
rationalise=rationalisation
rationalizes=rationalizations
rationalises=rationalisations
# react=overreaction
# reacts=overreactions
react=reaction
reacts=reactions
realign=realignment
realigns=realignments
realize=realization
realise=realisation
realizes=realizations
realises=realisations
reappear=reappearance
reappears=reappearances
rearrange=rearrangement
rearranges=rearrangements
# rearrange=reordering
# rearranges=reorderings
reassess=reassessment
reassesses=reassessments
reassign=reassignment
reassigns=reassignments
reassure=reassurance
reassures=reassurances
recalculate=recalculation
recalculates=recalculations
recant=recantation
recants=recantations
# receive=procurement
# receives=procurements
receive=reception
receives=receptions
receive=recipient
receives=recipients
reckon=reckoning
reckons=reckonings
recognize=recognition
recognizes=recognitions
recommend=recommendation
recommends=recommendations
# reconcile=rapprochement
# reconciles=rapprochements
reconcile=reconciliation
reconciles=reconciliations
reconsider=reconsideration
reconsiders=reconsiderations
rectify=rectification
rectifies=rectifications
# recur=iteration
# recurs=iterations
recur=recurrence
recurs=recurrences
# recur=repetition
# recurs=repetitions
redeem=redemption
redeems=redemptions
redefine=redefinition
redefines=redefinitions
redeploy=redeployment
redeploies=redeployments
redevelop=redevelopment
redevelops=redevelopments
redistribute=redistribution
redistributes=redistributions
reduce=reduction
reduces=reductions
refinance=refinancing
refinances=refinancings
refine=refining
refines=refinings
reflect=reflection
reflects=reflections
refocus=refocusing
refocuss=refocusings
reformulate=reformulation
reformulates=reformulations
refurbish=refurbishing
refurbishs=refurbishings
# refurbish=refurbishment
# refurbishs=refurbishments
# regulate=ordinance
# regulates=ordinances
regulate=regulation
regulates=regulations
rehabilitate=rehabilitation
rehabilitates=rehabilitations
reimburse=reimbursement
reimburses=reimbursements
reinforce=reinforcement
reinforces=reinforcements
reinstate=reinstatement
reinstates=reinstatements
rejuvenate=rejuvenation
rejuvenates=rejuvenations
relate=relation
relates=relations
relax=relaxation
relaxs=relaxations
relocate=relocation
relocates=relocations
rely=reliance
relies=reliances
relieve=relief
relieves=reliefs
remember=remembrance
remembers=remembrances
renegotiate=renegotiation
renegotiates=renegotiations
renounce=renunciation
renounces=renunciations
renovate=renovation
renovates=renovations
reorganize=reorganization
reorganise=reorganisation
reorganizes=reorganizations
reorganises=reorganisations
# repay=remittance
# repaies=remittances
repay=repayment
repaies=repayments
replace=replacement
replaces=replacements
# represent=delegation
# represents=delegations
represent=representation
represents=representations
reproduce=reproduction
reproduces=reproductions
repudiate=repudiation
repudiates=repudiations
# require=criterion
# requires=criterions
# require=precondition
# requires=preconditions
require=requirement
requires=requirements
resemble=resemblance
resembles=resemblances
resent=resentment
resents=resentments
reside=residence
resides=residences
# reside=resident
# resides=residents
resign=resignation
resigns=resignations
respond=respondent
responds=respondents
restate=restatement
restates=restatements
restrain=forbearance
restrains=forbearances
restrict=restriction
restricts=restrictions
restructure=restructuring
restructures=restructurings
resurrect=resurrection
resurrects=resurrections
retain=retention
retains=retentions
retaliate=retaliation
retaliates=retaliations
# retaliate=retribution
# retaliates=retributions
retire=retirement
retires=retirements
retrench=retrenchment
retrenchs=retrenchments
reunite=reunion
reunites=reunions
reverberate=reverberation
reverberates=reverberations
satisfy=satisfaction
satisfies=satisfactions
saturate=density
saturates=densities
sheathe=sheath
sheathes=sheaths
signify=significance
signifies=significances
simulate=simulation
simulates=simulations
slay=slaying
slaies=slayings
soften=softening
softens=softenings
solicit=solicitation
solicits=solicitations
solve=solution
solves=solutions
soothe=sooth
soothes=sooths
spank=spanking
spanks=spankings
speak=accent
speaks=accents
specify=specification
specifies=specifications
speculate=speculation
speculates=speculations
spend=spending
spends=spendings
stabilize=stabilization
stabilise=stabilisation
stabilizes=stabilizations
stabilises=stabilisations
stagnate=stagnation
stagnates=stagnations
sterilize=sterilization
sterilise=sterilisation
sterilizes=sterilizations
sterilises=sterilisations
stimulate=stimulation
stimulates=stimulations
strengthen=strengthening
strengthens=strengthenings
submit=submission
submits=submissions
subscribe=subscription
subscribes=subscriptions
subsidize=subsidization
subsidise=subsidisation
subsidizes=subsidizations
subsidises=subsidisations
subtract=subtraction
subtracts=subtractions
# succeed=killing
# succeeds=killings
succeed=succession
succeeds=successions
sue=litigation
sues=litigations
# sue=proceeding
# sues=proceedings
suffer=suffering
suffers=sufferings
suggest=suggestion
suggests=suggestions
supervise=supervision
supervises=supervisions
# suppress=suppressant
# suppresses=suppressants
suppress=suppression
suppresses=suppressions
suspend=suspension
suspends=suspensions
# sustain=sustainability
# sustains=sustainabilities
sustain=sustenance
sustains=sustenances
sympathize=solidarity
sympathizes=solidarities
teach=teaching
teachs=teachings
televise=televising
televises=televisings
tell=storytelling
tells=storytellings
teethe=teeth
# teethes=teeths
# teeths is actually tooth
tempt=temptation
tempts=temptations
terminate=termination
terminates=terminations
tighten=tightening
tightens=tightenings
tolerate=tolerance
tolerates=tolerances
transact=transaction
transacts=transactions
translate=translation
translates=translations
transmit=transmission
transmits=transmissions
understand=understanding
understands=understandings
understate=understatement
understates=understatements
undertake=undertaking
undertakes=undertakings
underwrite=underwriting
underwrites=underwritings
# unify=reunification
# unifies=reunifications
unify=unification
unifies=unifications
unite=union
unites=unions
# unite=unity
# unites=unities
unravel=unraveling
unravels=unravelings
unsettle=unsettlement
unsettles=unsettlements
unveil=unveiling
unveils=unveilings
usurp=usurpation
usurps=usurpations
utilize=utilization
utilise=utilisation
utilizes=utilizations
utilises=utilisations
vary=variation
varies=variations
ventilate=ventilation
ventilates=ventilations
verify=verification
verifies=verifications
vindicate=vindication
vindicates=vindications
# violate=infraction
# violates=infractions
violate=violation
violates=violations
warn=warning
warns=warnings
weaken=weakening
weakens=weakenings
whine=wine
whines=wines
widen=widening
widens=widenings
worsen=worsening
worsens=worsenings
wreathe=wreath
wreathes=wreaths
write=writing
writes=writings
###      Phrasal verbs         ###
###    verb <- noun direction  ###
### only works one way for now ###
back down=backdown
backs down=backdowns
backs up=backups
backs up=back-ups
back up=backup
back up=back-up
bail out=bailout
bails out=bailouts
beats up=beat-ups
beat up=beat-up
blast off=blastoff
blasts off=blastoffs
blow out=blowout
blows out=blowouts
blows up=blowups
blows up=blow-ups
blow up=blowup
blow up=blow-up
boil over=boilover
boils over=boilovers
break away=breakaway
break down=breakdown
break down=break-down
break out=breakout
break out=break-out
breaks away=breakaways
breaks down=breakdowns
breaks down=break-downs
breaks out=breakouts
breaks out=break-outs
breaks through=breakthroughs
breaks through=break-throughs
breaks up=breakups
break through=breakthrough
break through=break-through
break up=breakup
brush off=brushoff
brushs off=brushoffs
builds up=buildups
build up=buildup
burn off=burnoff
burn out=burnout
burn out=burn-out
burns off=burnoffs
burns out=burnouts
burns out=burn-outs
buy in=buy-in
buy off=buyoff
buy out=buyout
buys in=buy-ins
buys off=buyoffs
buys out=buyouts
call back=callback
call back=call-back
calls back=callbacks
calls back=call-backs
carries on=carry-ons
carry on=carry-on
cash in=cash-in
cash out=cashout
cash out=cash-out
cashs in=cash-ins
cashs out=cashouts
cashs out=cash-outs
catchs up=catchups
catchs up=catch-ups
catch up=catchup
catch up=catch-up
cave in=cave-in
caves in=cave-ins
change over=changeover
changes over=changeovers
check in=checkin
check in=check-in
check out=checkout
check out=check-out
checks in=checkins
checks in=check-ins
checks out=checkouts
checks out=check-outs
checks up=checkups
check up=checkup
chill out=chillout
chill out=chill-out
chills out=chillouts
chills out=chill-outs
clamp down=clampdown
clamps down=clampdowns
claw back=clawback
claws back=clawbacks
clean out=cleanout
cleans out=cleanouts
cleans up=cleanups
cleans up=clean-ups
clean up=cleanup
clean up=clean-up
clicks through=clickthroughs
click through=clickthrough
close in=close-in
close out=closeout
closes in=close-ins
closes out=closeouts
closes up=closeups
closes up=close-ups
close up=closeup
close up=close-up
come back=comeback
come back=come-back
come down=comedown
come on=come-on
comes back=comebacks
comes back=come-backs
comes down=comedowns
comes on=come-ons
cool down=cooldown
cool down=cool-down
cools down=cooldowns
cools down=cool-downs
cop out=copout
cop out=cop-out
cops out=copouts
cops out=cop-outs
crack down=crackdown
cracks down=crackdowns
cut back=cutback
cut out=cutout
cut out=cut-out
cuts back=cutbacks
cuts out=cutouts
cuts out=cut-outs
die off=die-off
dies off=die-offs
draw back=drawback
draw down=drawdown
draws back=drawbacks
draws down=drawdowns
dresses up=dressups
dresses up=dress-ups
dress up=dressup
dress up=dress-up
drive by=drive-by
drives by=drive-bies
drop down=dropdown
drop down=drop-down
drop off=drop-off
drop out=dropout
drops down=dropdowns
drops down=drop-downs
drops off=drop-offs
drops out=dropouts
face off=face-off
faces off=face-offs
fall back=fallback
fall back=fall-back
fall off=falloff
falls back=fallbacks
falls back=fall-backs
falls off=falloffs
feed back=feedback
feed back=feed-back
feeds back=feedbacks
feeds back=feed-backs
fill out=fill-out
fills out=fill-outs
fixs up=fix-ups
fix up=fix-up
flame out=flameout
flames out=flameouts
flares up=flareups
flares up=flare-ups
flare up=flareup
flare up=flare-up
flies by=flybies
flies over=flyovers
fly by=flyby
fly over=flyover
folds up=fold-ups
fold up=fold-up
follows through=follow-throughs
follows up=followups
follows up=follow-ups
follow through=follow-through
follow up=followup
follow up=follow-up
freak out=freakout
freak out=freak-out
freaks out=freakouts
freaks out=freak-outs
freeze out=freeze-out
freezes out=freeze-outs
gad about=gadabout
gads about=gadabouts
get away=getaway
gets away=getaways
give away=giveaway
give away=give-away
give back=giveback
gives away=giveaways
gives away=give-aways
gives back=givebacks
go ahead=go-ahead
go by=go-by
goes ahead=go-aheads
goes by=go-bies
goof off=goof-off
goofs off=goof-offs
go slow=go-slow
hand off=handoff
hand off=hand-off
hand out=handout
hands off=handoffs
hands off=hand-offs
hands out=handouts
hang out=hangout
hang out=hang-out
hangs out=hangouts
hangs out=hang-outs
hangs up=hangups
hangs up=hang-ups
hang up=hangup
hang up=hang-up
hold back=holdback
hold out=holdout
holds back=holdbacks
holds out=holdouts
hooks up=hookups
hooks up=hook-ups
hook up=hookup
hook up=hook-up
keep away=keepaway
keeps away=keepaways
kick back=kickback
kick back=kick-back
kick off=kick-off
kicks back=kickbacks
kicks back=kick-backs
kicks off=kick-offs
kisses off=kiss-offs
kiss off=kiss-off
knock down=knock-down
knock off=knockoff
knocks down=knock-downs
knocks off=knockoffs
lay off=layoff
lay off=lay-off
lay out=layout
lay out=lay-out
lays off=layoffs
lays off=lay-offs
lays out=layouts
lays out=lay-outs
let down=letdown
lets down=letdowns
lie down=lie-down
lies down=lie-downs
lift off=liftoff
lifts off=liftoffs
lines up=lineups
lines up=line-ups
line up=lineup
line up=line-up
live in=live-in
lives in=live-ins
lock down=lockdwon
locks down=lockdwons
locks up=lockups
lock up=lockup
log in=login
log in=log-in
log off=logoff
log off=log-off
log on=logon
log on=log-on
log out=logout
log out=log-out
logs in=logins
logs in=log-ins
logs off=logoffs
logs off=log-offs
logs on=logons
logs on=log-ons
logs out=logouts
logs out=log-outs
look in=look-in
look out=lookout
look out=look-out
looks in=look-ins
looks out=lookouts
looks out=look-outs
looks up=lookups
looks up=look-ups
look up=lookup
look up=look-up
make do=make-do
makes do=make-dos
makes up=makeups
makes up=make-ups
make up=makeup
make up=make-up
mark down=markdown
marks down=markdowns
marks up=markups
marks up=mark-ups
mark up=markup
mark up=mark-up
mashs up=mashups
mash up=mashup
mixs up=mix-ups
mix up=mix-up
mops up=mop-ups
mop up=mop-up
opt out=opt-out
opts out=opt-outs
passes through=pass-throughs
pass through=pass-through
pay back=payback
pay off=payoff
pay off=pay-off
pays back=paybacks
pays off=payoffs
pays off=pay-offs
phase out=phase-out
phases out=phase-outs
picks up=pickups
picks up=pick-ups
pick up=pickup
pick up=pick-up
pig out=pigout
pig out=pig-out
pigs out=pigouts
pigs out=pig-outs
pins up=pin-ups
pin up=pin-up
play back=playback
plays back=playbacks
plug in=plugin
plug in=plug-in
plugs in=plugins
plugs in=plug-ins
pop out=pop-out
pops out=pop-outs
pops up=popups
pops up=pop-ups
pop up=popup
pop up=pop-up
presses on=press-ons
press on=press-on
print out=printout
print out=print-out
prints out=printouts
prints out=print-outs
pull apart=pull-apart
pull down=pull-down
pull off=pull-off
pull over=pullover
pulls apart=pull-aparts
pulls down=pull-downs
pulls off=pull-offs
pulls over=pullovers
pushs up=push-ups
push up=push-up
put down=put-down
put on=put-on
puts down=put-downs
puts on=put-ons
ring back=ring-back
rings back=ring-backs
rip off=ripoff
rip off=rip-off
rips off=ripoffs
rips off=rip-offs
roll back=rollback
roll back=roll-back
roll out=rollout
roll out=roll-out
roll over=rollover
rolls back=rollbacks
rolls back=roll-backs
rolls out=rollouts
rolls out=roll-outs
rolls over=rollovers
rub down=rubdown
rubs down=rubdowns
run about=runabout
run around=runaround
run off=runoff
run off=run-off
runs about=runabouts
runs around=runarounds
runs off=runoffs
runs off=run-offs
runs up=runups
runs up=run-ups
run up=runup
run up=run-up
screws up=screwups
screws up=screw-ups
screw up=screwup
screw up=screw-up
sell off=sell-off
sells off=sell-offs
sends up=send-ups
send up=send-up
set aside=set-aside
set back=setback
sets aside=set-asides
sets back=setbacks
sets up=setups
sets up=set-ups
set up=setup
set up=set-up
shake down=shakedown
shakes down=shakedowns
shout out=shoutout
shout out=shout-out
shouts out=shoutouts
shouts out=shout-outs
show off=show-off
shows off=show-offs
shut down=shutdown
shut down=shut-down
shut in=shut-in
shut off=shutoff
shut off=shut-off
shuts down=shutdowns
shuts down=shut-downs
shuts in=shut-ins
shuts off=shutoffs
shuts off=shut-offs
sign in=signin
sign in=sign-in
sign on=sign-on
sign out=signout
sign out=sign-out
signs in=signins
signs in=sign-ins
signs on=sign-ons
signs out=signouts
signs out=sign-outs
signs up=signups
signs up=sign-ups
sign up=signup
sign up=sign-up
sit down=sit-down
sit in=sit-in
sits down=sit-downs
sits in=sit-ins
sits up=situps
sits up=sit-ups
sit up=situp
sit up=sit-up
sleep over=sleepover
sleep over=sleep-over
sleeps over=sleepovers
sleeps over=sleep-overs
slow down=slowdown
slow down=slow-down
slows down=slowdowns
slows down=slow-downs
spin off=spin-off
spins off=spin-offs
spits up=spitups
spit up=spitup
stand alone=standalone
stand alone=stand-alone
stand by=standby
stand by=stand-by
stand out=standout
stands alone=standalones
stands alone=stand-alones
stands by=standbys
stands by=stand-bys
stands out=standouts
stands up=standups
stands up=stand-ups
stand up=standup
stand up=stand-up
starts up=startups
starts up=start-ups
start up=startup
start up=start-up
sticks up=stickups
stick up=stickup
strike out=strikeout
strikes out=strikeouts
tag along=tagalong
tags along=tagalongs
take off=takeoff
take off=take-off
take out=takeout
take over=takeover
take over=take-over
takes off=takeoffs
takes off=take-offs
takes out=takeouts
takes over=takeovers
takes over=take-overs
tear down=teardown
tears down=teardowns
time out=timeout
time out=time-out
times out=timeouts
times out=time-outs
tip off=tipoff
tip off=tip-off
tips off=tipoffs
tips off=tip-offs
tops up=topups
tops up=top-ups
top up=topup
top up=top-up
touch down=touchdown
touchs down=touchdowns
touchs up=touch-ups
touch up=touch-up
trade in=trade-in
trades in=trade-ins
trickle down=trickle-down
trickles down=trickle-downs
tries out=tryouts
try out=tryout
try out=try-out
trys out=tryouts
trys out=try-outs
turn down=turndown
turn on=turn-on
turn over=turnover
turns down=turndowns
turns on=turn-ons
turns over=turnovers
voice over=voiceover
voices over=voiceovers
wakes up=wake-ups
wake up=wake-up
walk in=walk-in
walks in=walk-ins
walks through=walkthroughs
walks through=walk-throughs
walk through=walkthrough
walk through=walk-through
warms up=warmups
warms up=warm-ups
warm up=warmup
warm up=warm-up
wash out=washout
washs out=washouts
weigh in=weigh-in
weighs in=weigh-ins
white list=white-list
white out=whiteout
white out=white-out
whites list=white-lists
whites out=whiteouts
whites out=white-outs
winds up=windups
wind up=windup
work around=workaround
work around=work-around
work out=workout
work out=work-out
works around=workarounds
works around=work-arounds
works out=workouts
works out=work-outs
write down=writedown
write off=write-off
writes down=writedowns
writes off=write-offs
writes up=write-up
write up=write-up

