# word with corrected diacritization
# we can use it to handle ambiguation case
# words with diacritics
# For notes, refer to https://github.com/sohaibafifi/languagetool/issues/21
حراك=حَراك
تجربة=تجرِبة
تجارب=تجارِب
التجارب=التجارِب
الحنق=الحَنَق
الحضن=الحِضن
الذهاب=الذَّهاب
برغوث=بُرغوث
البرغوث=البُرغوث
المغص=المغْص
العصفور=العُصفور
عصفور=عُصفور
زنبور=زُنبور
الزنبور=الزُّنبور
تعالوا=تعالَوا
الثقب=الثَّقب
طازج=طازَج
الطازج=الطازَج
خيار=خِيار
الخيار=الخِيار
ميزة=مِيزة|مزيّة
الميزة=المِيزة|المزيّة
أكفاء=أكْفاء|أكفياء|كُفاة
الأكفاء=الأكْفاء|الأكفياء|الكُفاة
رفاهية=رَفَاهيَة
الرفاهية=الرَفَاهيَة
جمادى=جُمادى
خضراوات=خَضْراوات