# Multi word foreign expressions with Galician ones
# (c) 2016-2017 Tiago F. Santos
#
# Licensed under LGPL
# Translation from the Portuguese version assisted by Apertium 
#
curriculum vitae=currículo
Curriculum vitae=Currículo
abat-jour=quebra-luz
Abat-jour=Quebra-luz
abat-jours=quebra-luces
Abat-jours=Quebra-luces
# acordéon=acordeón
# acordéons=acordeóns
affair=no caso de que amoroso
Affair=No caso de que amoroso
affairs=casos amorosos
Affairs=Casos amorosos
afrikaans=africáner
Afrikaans=Africáner
# aftershave=loção de barbear
# aftershaves=loções de barbear
agrément=acordo
Agrément=Acordo
agréments=acordos
Agréments=Acordos
agreement=acordo
Agreement=Acordo
agreements=acordos
Agreements=Acordos
aide-mémoire=auxiliar de memoria
Aide-mémoire=Auxiliar de memoria
aide-mémoires=auxiliares de memoria
Aide-mémoires=Auxiliares de memoria
# aikido=aiquidô
# aikidos=aiquidôs
aileron=estabilizador
Aileron=Estabilizador
ailerons=estabilizadores
Ailerons=Estabilizadores
airbag=almofada de ar
Airbag=Almofada de ar
airbags=almofadas de ar
Airbags=Almofadas de ar
# anorak=anoraque
# anoraks=anoraques
anschluss=anexión
Anschluss=Anexión
anschlusses=anexións
Anschlusses=Anexións
# antidoping=antidopagem
# antidopings=antidopagens
appoggiatura=apoxiatura
Appoggiatura=Apoxiatura
appoggiaturas=apoxiaturas
Appoggiaturas=Apoxiaturas
apport=contribución
Apport=Contribución
apports=contribucións
Apports=Contribucións
# aquaplaning=aquaplanagem
# aquaplanings=aquaplanagens
arrière-pensée=segundas intencións
Arrière-pensée=Segundas intencións
arrière-pensées=segundas intencións
Arrière-pensées=Segundas intencións
assemblage=montaxe
Assemblage=Montaxe
assemblages=montaxes
Assemblages=Montaxes
assembler=montar
Assembler=Montar
assemblers=montares
Assemblers=Montares
atelier=taller
Atelier=Taller
ateliers=talleres
Ateliers=Talleres
attaché=adido
Attaché=Adido
attachés=adidos
Attachés=Adidos
avant-garde=vangarda
Avant-garde=Vangarda
avant-gardes=vangardas
Avant-gardes=Vangardas
# avant-première=antestreia
# avant-premières=antestreias
avant-scène=proscenio
Avant-scène=Proscenio
avant-scènes=proscenios
Avant-scènes=Proscenios
ayatollah=líder relixioso islámico
Ayatollah=Líder relixioso islámico
ayatollahs=líderes relixiosos islámicos
Ayatollahs=Líderes relixiosos islámicos
baby=bebé
Baby=Bebé
babies=bebés
Babies=Bebés
baby-sitter=ama
Baby-sitter=Ama
baby-sitters=amas
Baby-sitters=Amas
back-up=copia de seguranza
Back-up=Copia de seguranza
back-ups=copias de seguranza
Back-ups=Copias de seguranza
background=formación de base
Background=Formación de base
backgrounds=formacións de base
Backgrounds=Formacións de base
backstage=bastidores
Backstage=Bastidores
backstages=bastidores
Backstages=Bastidores
bacon=touciño fumado
Bacon=Touciño fumado
bacons=touciños fumados
Bacons=Touciños fumados
touciño defumado=touciño fumado
Touciño defumado=Touciño fumado
touciños defumados=touciños fumados
Touciños defumados=Touciños fumados
badge=distintivo
Badge=Distintivo
badges=distintivos
Badges=Distintivos
badminton=bádminton
Badminton=Bádminton
badmintons=bádmintons
Badmintons=Bádmintons
ballet=balé
Ballet=Balé
ballets=balés
Ballets=Balés
ballotage=segunda volta
Ballotage=Segunda volta
ballotages=segundas voltas
Ballotages=Segundas voltas
bandage=ligadura|faixa|venda
Bandage=Ligadura|faixa|venda
bandages=ligadura|faixa|vendas
Bandages=Ligadura|faixa|vendas
barbecue=churrasco
Barbecue=Churrasco
barbecues=churrascos
Barbecues=Churrascos
barman=empregado de bar
Barman=Empregado de bar
barmans=empregados de bar
Barmans=Empregados de bar
bâton=batom vermelho
Bâton=Batom vermelho
bâtons=batons vermelhos
Bâtons=Batons vermelhos
beat=batida
Beat=Batida
beats=batidas
Beats=Batidas
# beeper=bipe
# beepers=bipes
béguin=atracción
Béguin=Atracción
béguins=atraccións
Béguins=Atraccións
# benchmarking=aforo
# benchmarkings=aforos
berceuse=canto de arrolar|embalo
Berceuse=Canto de arrolar|embalo
berceuses=cantos de arrolar|embalos
Berceuses=Cantos de arrolar|embalos
best-seller=éxito de vendas
Best-seller=Éxito de vendas
best-sellers=éxitos de vendas
Best-sellers=Éxitos de vendas
bibelot=bugiganga
Bibelot=Bugiganga
bibelots=bugigangas
Bibelots=Bugigangas
biberon=biberón
Biberon=Biberón
biberons=biberóns
Biberons=Biberóns
bidon=canister
Bidon=Canister
bidons=canisteres
Bidons=Canisteres
bidonville=barrio de lata
Bidonville=Barrio de lata
bidonvilles=barrios de lata
Bidonvilles=Barrios de lata
bigoudi=rolo para o cabelo
Bigoudi=Rolo para o cabelo
bigoudis=rolos para o cabelo
Bigoudis=Rolos para o cabelo
bijou=bixutería
Bijou=Bixutería
bijous=bixuterías
Bijous=Bixuterías
# bikini=biquíni
# bikinis=biquínis
blackout=corte de enerxía
Blackout=Corte de enerxía
blackouts=cortes de enerxía
Blackouts=Cortes de enerxía
blasé=enfastiado
Blasé=Enfastiado
blasés=enfastiados
Blasés=Enfastiados
blazer=chaqueta
Blazer=Chaqueta
blazers=chaqueta
Blazers=Chaqueta
blitzkrieg=guerra lóstrego
Blitzkrieg=Guerra lóstrego
blitzkriegs=guerras lóstrego
Blitzkriegs=Guerras lóstrego
blockbuster=éxito de despacho de billetes
Blockbuster=Éxito de despacho de billetes
blockbusters=éxitos de despacho de billetes
Blockbusters=Éxitos de despacho de billetes
blue-jeans=calzas de ganga
Blue-jeans=Calzas de ganga
bluff=simulación
Bluff=Simulación
bluffs=simulacións
Bluffs=Simulacións
blush=colorete
Blush=Colorete
blushs=coloretes
Blushs=Coloretes
# bob=trenó
# bobs=trenós
# bobsleigh=trenó
# bobsleighs=trenós
# body=bódi
# bodies=bódis
body-building=culturismo
Body-building=Culturismo
body-buildings=culturismos
Body-buildings=Culturismos
boîte=discoteca
Boîte=Discoteca
boîtes=discotecas
Boîtes=Discotecas
boom=expansión|crecemento súbito
Boom=Expansión|crecemento súbito
booms=expansión|crecementos súbitos
Booms=Expansión|crecementos súbitos
# boomerang=bumerangue
# boomerangs=bumerangues
bordeaux=cor de viño
Bordeaux=Cor de viño
boss=xefe
Boss=Xefe
bosses=xefes
Bosses=Xefes
# bougainvillia=boliña
# bougainvillias=boliñas
boulevard=alameda
Boulevard=Alameda
boulevards=alamedas
Boulevards=Alamedas
bouquet=ramo de flores
Bouquet=Ramo de flores
bouquets=ramos de flores
Bouquets=Ramos de flores
# boutique=butique
# boutiques=butiques
boutonnière=botoeira
Boutonnière=Botoeira
boutonnières=botoeiras
Boutonnières=Botoeiras
# bowling=bólingue
# bowlings=bólingues
box=boxeo
Box=Boxeo
box-office=despacho de billetes
Box-office=Despacho de billetes
box-offices=despachos de billetes
Box-offices=Despachos de billetes
boxeur=puxilista
Boxeur=Puxilista
boxeurs=puxilistas
Boxeurs=Puxilistas
boy=paquete
Boy=Paquete
boys=paquetes
Boys=Paquetes
boyfriend=noivo
Boyfriend=Noivo
boyfriends=noivos
Boyfriends=Noivos
boysband=banda masculina
Boysband=Banda masculina
boysbands=bandas masculinas
Boysbands=Bandas masculinas
# braille=braile
# brailles=brailes
brandy=brande
Brandy=Brande
brandies=brandes
Brandies=Brandes
break=breque
Break=Breque
breaks=breques
Breaks=Breques
# brevet=brevete
# brevets=brevetes
bric-á-brac=bric-a-brac
Bric-á-brac=Bric-a-brac
bric-á-bracs=bric-a-bracs
Bric-á-bracs=Bric-a-bracs
bricolage=traballos manuais
Bricolage=Traballos manuais
bricolages=traballos manuais
Bricolages=Traballos manuais
# bridge=brídege
# bridges=brídeges
briefing=reunión informativa|documento informativo
Briefing=Reunión informativa|documento informativo
briefings=reunións informativas|documentos informativos
Briefings=Reunións informativas|documentos informativos
broker=corrector
Broker=Corrector
brokers=correctores
Brokers=Correctores
browser=navegador
Browser=Navegador
browsers=navegadores
Browsers=Navegadores
budget=orzamento
Budget=Orzamento
budgets=orzamentos
Budgets=Orzamentos
# buena-dicha=sina
# buena-dichas=sinas
buffer=memoria temporal
Buffer=Memoria temporal
buffers=memorias temporais
Buffers=Memorias temporais
buffet=bufete
Buffet=Bufete
buffets=bufetes
Buffets=Bufetes
bug=fallo
Bug=Fallo
bugs=fallos
Bugs=Fallos
# bulldog=buldogue
# bulldogs=buldogues
# bulldozer=buldózer
# bulldozers=buldózeres
# bungalow=bangaló
# bungalows=bangalós
bunker=abrigo subterráneo
Bunker=Abrigo subterráneo
bunkers=abrigos subterráneos
Bunkers=Abrigos subterráneos
bureau=despacho
Bureau=Despacho
bureaus=despachos
Bureaus=Despachos
bus=faixa-bus
Bus=Faixa-bus
buss=faixa-bus
Buss=Faixa-bus
business=negocio
Business=Negocio
businesses=negocios
Businesses=Negocios
businessman=home de negocios
Businessman=Home de negocios
businessmen=homes de negocios
Businessmen=Homes de negocios
bye-bye=adeus
Bye-bye=Adeus
bye-byes=adeus
Bye-byes=Adeus
bypass=derivação
Bypass=Derivação
bypasses=derivações
Bypasses=Derivações
cabaret=cabaré
Cabaret=Cabaré
cabarets=cabarés
Cabarets=Cabarés
cabriolet=convertible
Cabriolet=Convertible
cabriolets=convertibles
Cabriolets=Convertibles
cache=memoria transitoria
Cache=Memoria transitoria
caches=memorias transitorias
Caches=Memorias transitorias
# cache-pot=cachepô
# cache-pots=cachepôs
cachet=remuneración
Cachet=Remuneración
cachets=remuneracións
Cachets=Remuneracións
caddie=auxiliar
Caddie=Auxiliar
caddies=auxiliares
Caddies=Auxiliares
caddy=auxiliar
Caddy=Auxiliar
caddies=auxiliares
Caddies=Auxiliares
# calèche=caleça
# calèches=caleças
camelot=vendedor ambulante
Camelot=Vendedor ambulante
camelots=vendedores ambulantes
Camelots=Vendedores ambulantes
# camembert=camember
# camemberts=camemberes
cameraman=operador de cámara
Cameraman=Operador de cámara
cameramans=operadores de cámara
Cameramans=Operadores de cámara
camping=parque de campismo
Camping=Parque de campismo
campings=parques de campismo
Campings=Parques de campismo
cannabis=cánabo
Cannabis=Cánabo
# cannellone=canelone
# cannellones=canelones
# caoutchouc=cauchu
# caoutchoucs=cauchus
# capeline=capelina
# capelines=capelinas
capita=cabeza
Capita=Cabeza
# capot=capô
# capots=capôs
cappuccino=capuchino
Cappuccino=Capuchino
cappuccinos=capuchinos
Cappuccinos=Capuchinos
# cardigan=cardigã
# cardigans=cardigãs
carnet=carné
Carnet=Carné
carnets=carnés
Carnets=Carnés
cartoon=deseño humorístico|tira humorística
Cartoon=Deseño humorístico|tira humorística
cartoons=deseños humorísticos|tiras humorísticas
Cartoons=Deseños humorísticos|tiras humorísticas
case study=caso de estudo
Case study=Caso de estudo
case studies=casos de estudo
Case studies=Casos de estudo
case-study=caso de estudo
Case-study=Caso de estudo
case-studies=casos de estudo
Case-studies=Casos de estudo
cash=a diñeiro
Cash=A diñeiro
cash-flow=fluxo de caixa
Cash-flow=Fluxo de caixa
cash-flows=fluxos de caixa
Cash-flows=Fluxos de caixa
cast=elenco
Cast=Elenco
casts=elencos
Casts=Elencos
casting=audición
Casting=Audición
castings=audicións
Castings=Audicións
# catamaran=catamarã
# catamarans=catamarãs
# caterpillar=caterpílar
# caterpillars=caterpílares
CEO=director executivo
CEOs=directores executivos
chairman=presidente
Chairman=Presidente
chairmans=presidentes
Chairmans=Presidentes
champagne=champaña
Champagne=Champaña
champagnes=champañas
Champagnes=Champañas
champignon=cogumelo|seta
Champignon=Cogumelo|seta
champignons=cogumelos|setas
Champignons=Cogumelos|setas
chance=hipótese
Chance=Hipótese
chances=hipóteses
Chances=Hipóteses
chantilly=crema batida
Chantilly=Crema batida
chantillies=crema batida
Chantillies=Crema batida
charge=caricatura
Charge=Caricatura
charges=caricaturas
Charges=Caricaturas
charter=avión fretado
Charter=Avión fretado
charters=avións fretados
Charters=Avións fretados
chat=sala de conversación
Chat=Sala de conversación
chats=salas de conversación
Chats=Salas de conversación
chauffage=quecemento
Chauffage=Quecemento
chauffages=quecementos
Chauffages=Quecementos
chauffeur=condutor
Chauffeur=Condutor
chauffeurs=condutores
Chauffeurs=Condutores
check-in=rexistro de entrada
Check-in=Rexistro de entrada
check-ins=rexistros de entrada
Check-ins=Rexistros de entrada
check-up=exame xeral
Check-up=Exame xeral
check-ups=exames xerais
Check-ups=Exames xerais
checklist=alista de verificación
Checklist=Alista de verificación
checklists=listas de verificación
Checklists=Listas de verificación
checkout=rexistro de saída
Checkout=Rexistro de saída
checkouts=rexistros de saídas
Checkouts=Rexistros de saídas
checkpoint=posto de control
Checkpoint=Posto de control
checkpoints=postos de controis
Checkpoints=Postos de controis
cheeseburger=hamburguesa de queixo
Cheeseburger=Hamburguesa de queixo
cheeseburgers=hamburguesas de queixo
Cheeseburgers=Hamburguesas de queixo
cheesecake=torta de queixo
Cheesecake=Torta de queixo
cheesecakes=tortas de queixos
Cheesecakes=Tortas de queixos
chef=xefe
Chef=Xefe
chefs=xefes
Chefs=Xefes
cherry=licor de cereixa
Cherry=Licor de cereixa
cherries=licores de cereixas
Cherries=Licores de cereixas
# chiffon=chifom
# chiffons=chifons
chip=circuíto integrado
Chip=Circuíto integrado
chips=circuítos integrados
Chips=Circuítos integrados
ciào=adios
Ciào=Adios
ciàos=adios
Ciàos=Adios
cinderella=gata borralleira
Cinderella=Gata borralleira
cinderellas=gatas borralleiras
Cinderellas=Gatas borralleiras
clearing=liquidación
Clearing=Liquidación
clearings=liquidacións
Clearings=Liquidacións
# clip=clipe
# clips=clipes
# clipper=clíper
# clippers=clíperes
close-up=gran plano
Close-up=Gran plano
close-ups=grandes planos
Close-ups=Grandes planos
na cloud=na nube|na Internet
Na cloud=Na nube|na Internet
vía cloud=pola nube|pola Internet
Vía cloud=Pola nube|pola Internet
cloud=nube
Cloud=Nube
cockpit=habitáculo
Cockpit=Habitáculo
cockpits=habitáculos
Cockpits=Habitáculos
code-share=repartición de código
Code-share=Repartición de código
code-shares=reparticións de código
Code-shares=Reparticións de código
# collants=medias
compère=animador
Compère=Animador
compères=animadores
Compères=Animadores
complot=trama|conspiración
Complot=Trama|conspiración
complots=trama|conspiracións
Complots=Trama|conspiracións
# confetti=confete
# confettis=confetes
# consommé=consomê
# consommés=consomês
cool=calmo
Cool=Calmo
cools=calmos
Cools=Calmos
copyright=dereito de autor
Copyright=Dereito de autor
copyrights=dereitos de autor
Copyrights=Dereitos de autor
copywriter=redactor publicitario
Copywriter=Redactor publicitario
copywriters=redactores publicitarios
Copywriters=Redactores publicitarios
cornetto=corneto
Cornetto=Corneto
cornettos=cornetos
Cornettos=Cornetos
cornflakes=flocos de cereais
Cornflakes=Flocos de cereais
# couché=cuchê
# couchés=cuchês
# couchette=cuchete
# couchettes=cuchetes
coupé=coche deportivo convertible
Coupé=Coche deportivo convertible
coupés=coches deportivos convertibles
Coupés=Coches deportivos convertibles
coupon=cupón
Coupon=Cupón
coupons=cupóns
Coupons=Cupóns
courgette=curge
Courgette=Curge
courgettes=curges
Courgettes=Curges
court=campo de tenis
Court=Campo de tenis
courts=campos de tenis
Courts=Campos de tenis
couscous=cuscús
Couscous=Cuscús
couvert=entrada|aperitivos
Couvert=Entrada|aperitivos
couverts=entrada|aperitivos
Couverts=Entrada|aperitivos
cowboy=vaqueiro
Cowboy=Vaqueiro
cowboys=vaqueiros
Cowboys=Vaqueiros
crack=crac
Crack=Crac
cracks=crac
Cracks=Crac
# crapaud=crapô
# crapauds=crapôs
crash=colapso súbito
Crash=Colapso súbito
crashs=colapsos súbitos
Crashs=Colapsos súbitos
crawl=libre
Crawl=Libre
crawls=libres
Crawls=Libres
# crayon=craião
# crochet=croché
# crochets=crochés
croquis=esbozo
Croquis=Esbozo
# cross=crosse
# crosses=crosses
# cross-country=crosse
# cross-countries=crosses
cross-selling=venda cruzada
Cross-selling=Venda cruzada
cross-sellings=vendas cruzadas
Cross-sellings=Vendas cruzadas
# croupier=crupiê
# croupiers=crupiês
currency=moeda corrente
Currency=Moeda corrente
currencies=moedas correntes
Currencies=Moedas correntes
# cuvette=cuvete
# cuvettes=cuvetes
cyberspace=espazo virtual
Cyberspace=Espazo virtual
cyberspaces=espazos virtuais
Cyberspaces=Espazos virtuais
cyborg=ciborg
Cyborg=Ciborg
cyborgs=ciborgues
Cyborgs=Ciborgues
dancing=discoteca
Dancing=Discoteca
dancings=discotecas
Dancings=Discotecas
dandy=dandi
Dandy=Dandi
dandies=dandis
Dandies=Dandis
deadline=data-límite
Deadline=Data-límite
deadlines=data-límites
Deadlines=Data-límites
dealer=operador de mercados
Dealer=Operador de mercados
dealers=operadores de mercados
Dealers=Operadores de mercados
dealer=traficante de droga
Dealer=Traficante de droga
dealers=traficantes de drogas
Dealers=Traficantes de drogas
débacle=debacle
Débacle=Debacle
débacles=debacles
Débacles=Debacles
début=estrea|estrea social
Début=Estrea|estrea social
débuts=estrea|estreas sociais
Débuts=Estrea|estreas sociais
décalage=desfasamento
Décalage=Desfasamento
décalages=desfasamentos
Décalages=Desfasamentos
decanter=decantador
Decanter=Decantador
decanters=decantadores
Decanters=Decantadores
deck=convés
Deck=Convés
decks=convés
Decks=Convés
décor=escenario
Décor=Escenario
décors=escenarios
Décors=Escenarios
degradé=escala matizada|cabelo escadeado
Degradé=Escala matizada|cabelo escadeado
degradés=escalas matizadas|cabelos escadeados
Degradés=Escalas matizadas|cabelos escadeados
déjà-vu=paramnesia
Déjà-vu=Paramnesia
déjà-vus=paramnesias
Déjà-vus=Paramnesias
delivery=entrega
Delivery=Entrega
deliveries=entregas
Deliveries=Entregas
démarche=dilixencia
Démarche=Dilixencia
démarches=dilixencias
Démarches=Dilixencias
démodé=fóra de moda
Démodé=Fóra de moda
démodés=fóra de moda
Démodés=Fóra de moda
derby=gran competición deportiva
Derby=Gran competición deportiva
derbies=grandes competicións deportivas
Derbies=Grandes competicións deportivas
design=deseño industrial
Design=Deseño industrial
designs=deseños industriais
Designs=Deseños industriais
designer=deseñador profesional|deseñador
Designer=Deseñador profesional|deseñador
designers=deseñadores profesional|deseñadores
Designers=Deseñadores profesional|deseñadores
dessert=sobremesa
Dessert=Sobremesa
desserts=sobremesas
Desserts=Sobremesas
# destroyer=contratorpedeiro
# destroyers=contratorpedeiros
détente=descompresión
Détente=Descompresión
détentes=descompresións
Détentes=Descompresións
diesel=gasóleo
Diesel=Gasóleo
diesels=gasóleos
Diesels=Gasóleos
diesel=gasóleo
Diesel=Gasóleo
diesels=gasóleos
Diesels=Gasóleos
# disc-jockey=disco-jóquei
# disc-jockeys=disco-jóqueis
diskette=disquete
Diskette=Disquete
diskettes=disquetes
Diskettes=Disquetes
display=expositor
Display=Expositor
displays=expositores
Displays=Expositores
# dobermann=dobermane
# dobermanns=dobermanes
# donut=dónute
# donuts=dónutes
# dope=dopante
# dopes=dopantes
# doping=dope
# dopings=dopes
dossiê=carpeta|arquivo
Dossiê=Carpeta|arquivo
dossiês=carpetas|arquivos
Dossiês=Carpetas|arquivos
dossier=carpeta|arquivo
Dossier=Carpeta|arquivo
dossiers=carpetas|arquivos
Dossiers=Carpetas|arquivos
download=transferencia|trasladar
Download=Transferencia|trasladar
downloads=transferencias
Downloads=Transferencias
downsizing=redución de custos
Downsizing=Redución de custos
downsizings=reducións de custos
Downsizings=Reducións de custos
downtown=#baixo
Downtown=#baixo
downtowns=#baixo
Downtowns=#baixo
drink=bebida
Drink=Bebida
drinks=bebidas
Drinks=Bebidas
driver=taco
Driver=Taco
drivers=tacos
Drivers=Tacos
e-book=libro electrónico
E-book=Libro electrónico
e-books=libros electrónicos
E-books=Libros electrónicos
e-mail=correo electrónico
E-mail=Correo electrónico
e-mails=correos electrónicos
E-mails=Correos electrónicos
e-zine=revista electrónica
E-zine=Revista electrónica
e-zines=revistas electrónicas
E-zines=Revistas electrónicas
eau-de-toilette=auga de colonia
Eau-de-toilette=Auga de colonia
eau-de-toilettes=augas de colonia
Eau-de-toilettes=Augas de colonia
# écarté=ecartê
# écartés=ecartês
# écharpe=echarpe
# écharpes=echarpes
# éclair=ecler
# éclairs=ecleres
eco-friendly=amigo do ambiente
Eco-friendly=Amigo do ambiente
eco-friendlies=amigos do ambiente
Eco-friendlies=Amigos do ambiente
écran=pantalla
Écran=Pantalla
écrans=pantallas
Écrans=Pantallas
editing=edición|publicación
Editing=Edición|publicación
editings=edicións|publicaciónes
Editings=Edicións|publicaciónes
édredon=colcha
Édredon=Colcha
édredons=colchas
Édredons=Colchas
eighties=anos oitenta
Eighties=Anos oitenta
# élan=elã
# élans=elãs
encore=bis
Encore=Bis
encores=bis
Encores=Bis
engagé=implicado|implicada
Engagé=Implicado|implicada
engagés=implicados|implicadas
Engagés=Implicados|implicadas
enjambement=gravamen
Enjambement=Gravamen
enjambements=gravamens
Enjambements=Gravamens
entertainer=animador
Entertainer=Animador
entertainers=animadores
Entertainers=Animadores
entertainment=entretemento
Entertainment=Entretemento
entertainments=entretementos
Entertainments=Entretementos
entourage=círculo persoal
Entourage=Círculo persoal
entourages=círculos persoais
Entourages=Círculos persoais
entrecôte=entrecosto
Entrecôte=Entrecosto
entrecôtes=entrecostos
Entrecôtes=Entrecostos
establishment=clase dominante
Establishment=Clase dominante
establishments=clases dominantes
Establishments=Clases dominantes
estore=persiana
Estore=Persiana
estores=persianas
Estores=Persianas
exit=saída
Exit=Saída
exits=saídas
Exits=Saídas
expert=especialista
Expert=Especialista
experts=especialistas
Experts=Especialistas
expertise=pericia
Expertise=Pericia
expertises=pericias
Expertises=Pericias
extranet=rede externa
Extranet=Rede externa
extranets=redes externas
Extranets=Redes externas
eye-liner=delineador de ollos
Eye-liner=Delineador de ollos
eye-liners=delineadores de ollos
Eye-liners=Delineadores de ollos
eyeliner=delineador de ollos
Eyeliner=Delineador de ollos
eyeliners=delineadores de ollos
Eyeliners=Delineadores de ollos
factoring=cesión financeira
Factoring=Cesión financeira
factorings=cesións financeiras
Factorings=Cesións financeiras
fait diver=feito diversos
Fait diver=Feito diversos
fait divers=feitos diversos
Fait divers=Feitos diversos
# fan=fanático|admirador
# fans=fanáticos|admiradores
farniente=ociosidade
Farniente=Ociosidade
farnientes=ociosidades
Farnientes=Ociosidades
fauteuil=poltrona
Fauteuil=Poltrona
fauteuils=poltronas
Fauteuils=Poltronas
# fax=faxe
# faxes=fax
feddayin=guerrilleiros palestinos
Feddayin=Guerrilleiros palestinos
feddayins=guerrilleiros palestinos
Feddayins=Guerrilleiros palestinos
feedback=opinión|comentario
Feedback=Opinión|comentario
feedbacks=opinións|comentarios
Feedbacks=Opinións|comentarios
feeling=sensación
Feeling=Sensación
feelings=sensacións
Feelings=Sensacións
# féerie=feeria
# féeries=feerias
ferry=cacilheiro
Ferry=Cacilheiro
ferrys=cacilheiros
Ferrys=Cacilheiros
ferries=cacilheiros
Ferries=Cacilheiros
ferryboat=cacilheiro
Ferryboat=Cacilheiro
ferryboats=cacilheiros
Ferryboats=Cacilheiros
fifties=anos cincuenta
Fifties=Anos cincuenta
finesse=requinte
Finesse=Requinte
finesses=requintes
Finesses=Requintes
firewall=barreira de seguranza
Firewall=Barreira de seguranza
firewalls=barreiras de seguranzas
Firewalls=Barreiras de seguranzas
fixing=fixación de cambio
Fixing=Fixación de cambio
fixings=fixacións de cambios
Fixings=Fixacións de cambios
# flan=flã
# flans=flãs
# flash=flache
# flashs=flaches
flashback=retrospectiva
Flashback=Retrospectiva
flashbacks=retrospectivas
Flashbacks=Retrospectivas
flat=apartamento
Flat=Apartamento
flats=apartamentos
Flats=Apartamentos
# flipper=flíper
# flippers=flíperes
flirt=galantería
Flirt=Galantería
flirts=galanterías
Flirts=Galanterías
flop=fracaso
Flop=Fracaso
flops=fracasos
Flops=Fracasos
flutter=fibrilación
Flutter=Fibrilación
flutters=fibrilacións
Flutters=Fibrilacións
follow-up=continuación
Follow-up=Continuación
follow-ups=continuacións
Follow-ups=Continuacións
footing=camiñada
Footing=Camiñada
footings=camiñadas
Footings=Camiñadas
forcing=esforzo
Forcing=Esforzo
forcings=esforzos
Forcings=Esforzos
forties=anos corenta
Forties=Anos corenta
franchise=contrato de franquía
Franchise=Contrato de franquía
franchises=contratos de franquías
Franchises=Contratos de franquías
franchising=contrato de franquía
Franchising=Contrato de franquía
franchisings=contratos de franquías
Franchisings=Contratos de franquías
free=libre
Free=Libre
frees=libres
Frees=Libres
freelance=autónomo
Freelance=Autónomo
freelances=autónomos
Freelances=Autónomos
freelancer=autónomo
Freelancer=Autónomo
freelancers=autónomos
Freelancers=Autónomos
# froufrou=frufru
# froufrous=frufrus
# fuel=combustíbel
# fuels=combustíbeis
# führer=xefe
# führers=xefes
full-equipo=tempo enteiro
Full-equipo=Tempo enteiro
full-equipos=tempo enteiro
Full-equipos=Tempo enteiro
full-equipo=tempo enteiro
Full-equipo=Tempo enteiro
full-equipos=tempo enteiro
Full-equipos=Tempo enteiro
funding=capitalización
Funding=Capitalización
fundings=capitalizacións
Fundings=Capitalizacións
gadget=bugiganga
Gadget=Bugiganga
gadgets=bugigangas
Gadgets=Bugigangas
gaffe=deslice|descoido
Gaffe=Deslice|descoido
gaffes=deslice|descoidos
Gaffes=Deslice|descoidos
gag=broma
Gag=Broma
gags=bromas
Gags=Bromas
# gang=gangue
# gangs=gangues
gangster=gánster
Gangster=Gánster
gangsters=gánsteres
Gangsters=Gánsteres
gap=hiato
Gap=Hiato
gaps=hiatos
Gaps=Hiatos
garçon=camareiro
Garçon=Camareiro
garçons=camareiros
Garçons=Camareiros
garçonne=camareira
Garçonne=Camareira
garçonnes=camareiras
Garçonnes=Camareiras
# gauche=canhestro
# gauches=canhestros
gay=homosexual
Gay=Homosexual
gays=homosexuais
Gays=Homosexuais
gay=homosexual
Gay=Homosexual
gays=homosexuais
Gays=Homosexuais
geisha=gueixa
Geisha=Gueixa
geishas=gueixas
Geishas=Gueixas
gentleman=señor
Gentleman=Señor
gentlemans=señores
Gentlemans=Señores
ghetto=gueto
Ghetto=Gueto
ghettos=guetos
Ghettos=Guetos
# gigolo=gigolô
# gigolos=gigolôs
# gilet=gilé
# gilets=gilés
# gin=gim
glamour=encanto
Glamour=Encanto
glamours=encantos
Glamours=Encantos
# globetrotter=vagamundo
# globetrotters=vagamundos
# gneisse=gnaisse
# gneisses=gnaisses
goal-average=diferenza de goles
Goal-average=Diferenza de goles
goal-averages=diferenzas de goles
Goal-averages=Diferenzas de goles
# godet=godé
# godets=godés
# godet=godé
# godets=godés
# golf=golf
# golfs=golfs
# gong=gongo
# gongs=gongos
goodbye=adeus
Goodbye=Adeus
goodbyes=adeus
Goodbyes=Adeus
goulag=campo de traballos forzados
Goulag=Campo de traballos forzados
goulags=campos de traballos forzados
Goulags=Campos de traballos forzados
gourmet=gastrónomo
Gourmet=Gastrónomo
gourmets=gastrónomos
Gourmets=Gastrónomos
# graffiti=grafito
# graffitis=grafitos
green=campo de golf|verde
Green=Campo de golf|verde
greens=campos de golfs|verdes
Greens=Campos de golfs|verdes
# grenat=grená
# grenats=grenás
# grenat=grená
# grenats=grenás
griffe=etiqueta|marca luxosa
Griffe=Etiqueta|marca luxosa
griffes=etiqueta|marcas luxosas
Griffes=Etiqueta|marcas luxosas
grill=parrilla
Grill=Parrilla
grills=parrillas
Grills=Parrillas
groom=paquete
Groom=Paquete
grooms=paquetes
Grooms=Paquetes
gross=resultado bruto
Gross=Resultado bruto
grosses=resultados brutos
Grosses=Resultados brutos
guichet=ventá de billetes
Guichet=Ventá de billetes
guichets=ventás de billetes
Guichets=Ventás de billetes
# habitué=frequentador
# habitués=frequentadores
hacker=pirata informático
Hacker=Pirata informático
hackers=piratas informáticos
Hackers=Piratas informáticos
hall=corredor|vestíbulo
Hall=Corredor|vestíbulo
halls=corredores|vestíbulos
Halls=Corredores|vestíbulos
hamburger=hamburguesa
Hamburger=Hamburguesa
hambúrguer=hamburguesa
Hambúrguer=Hamburguesa
hamburgers=hamburguesas
Hamburgers=Hamburguesas
hambúrgueres=hamburguesas
Hambúrgueres=Hamburguesas
hamster=hámster
Hamster=Hámster
hamsters=hámsteres
Hamsters=Hámsteres
handicap=desvantaxe
Handicap=Desvantaxe
handicaps=desvantaxes
Handicaps=Desvantaxes
handling=operación
Handling=Operación
handlings=operacións
Handlings=Operacións
happening=acontecemento
Happening=Acontecemento
happenings=acontecementos
Happenings=Acontecementos
hara-kiri=haraquiri
Hara-kiri=Haraquiri
hara-kiris=haraquiris
Hara-kiris=Haraquiris
hard=duro
Hard=Duro
hards=duros
Hards=Duros
hard-core=pornográfico
Hard-core=Pornográfico
hard-cores=pornográficos
Hard-cores=Pornográficos
hardware=equipamento físico
Hardware=Equipamento físico
hardwares=equipamentos físicos
Hardwares=Equipamentos físicos
headphones=auriculares
Headphones=Auriculares
hi-fi=alta-fidelidade
Hi-fi=Alta-fidelidade
hi-fis=alta-fidelidades
Hi-fis=Alta-fidelidades
high definition=alta definición
High definition=Alta definición
High Defenition=Alta Definición
high-tech=alta-tecnoloxía
High-tech=Alta-tecnoloxía
high-techs=alta-tecnoloxías
High-techs=Alta-tecnoloxías
hit=éxito
Hit=Éxito
hits=éxitos
Hits=Éxitos
hobby=pasatempo
Hobby=Pasatempo
hobbies=pasatempos
Hobbies=Pasatempos
holding=sociedade xestora de participacións sociais
Holding=Sociedade xestora de participacións sociais
holdings=sociedades xestoras de participacións sociais
Holdings=Sociedades xestoras de participacións sociais
# hooligan=holígane
# hooligans=holíganes
# hors-d'oeuvre=acepipe
# hors-d'oeuvres=acepipes
horsepower=cabalo-vapor
Horsepower=Cabalo-vapor
horsepowers=cabalo-vapores
Horsepowers=Cabalo-vapores
hostel=pousada da xuventude
Hostel=Pousada da xuventude
hostels=pousadas da xuventude
Hostels=Pousadas da xuventude
hot=quente
Hot=Quente
hots=quentes
Hots=Quentes
# hovercraft=aerodeslizador
# hovercrafts=aerodeslizadores
# hydrofoil=hidroplanador
# hydrofoils=hidroplanadores
ice-cream=xeado
Ice-cream=Xeado
ice-creams=xeados
Ice-creams=Xeados
iceberg=montaña de xeo|masa de xeo
Iceberg=Montaña de xeo|masa de xeo
icebergs=montañas de xeo|masas de xeo
Icebergs=Montañas de xeo|masas de xeo
igloo=iglú
Igloo=Iglú
igloos=iglús
Igloos=Iglús
impeachment=destitución
Impeachment=Destitución
impeachments=destitucións
Impeachments=Destitucións
import-export=importación-exportación
Import-export=Importación-exportación
import-exports=importacións-exportacións
Import-exports=Importacións-exportacións
indoor=ambiente pechado
Indoor=Ambiente pechado
indoors=ambientes pechados
Indoors=Ambientes pechados
indoor=ambiente pechado
Indoor=Ambiente pechado
indoors=ambientes pechados
Indoors=Ambientes pechados
input=entrada
Input=Entrada
inputs=entradas
Inputs=Entradas
insight=intuición
Insight=Intuición
insights=intuicións
Insights=Intuicións
intelligentzia=intelixencia
Intelligentzia=Intelixencia
intelligentzias=intelixencias
Intelligentzias=Intelixencias
# intermezzo=entremez
# intermezzos=entremezes
intranet=rede interna
Intranet=Rede interna
intranets=redes internas
Intranets=Redes internas
# jabot=jabô
# jabots=jabôs
# jacuzzi=jacúzi
# jacuzzis=jacúzis
jeans=calzas de ganga
Jeans=Calzas de ganga
# jeep=jipe
# jeeps=jipes
# jerrican=jerricã
# jerricans=jerricãs
# jerrycan=jerricã
# jerrycans=jerricãs
jersey=xersei
Jersey=Xersei
jerseys=xerseis
Jerseys=Xerseis
jet=avión a reacción
Jet=Avión a reacción
jets=avións a reacción
Jets=Avións a reacción
jetfoil=avión de planeador
Jetfoil=Avión de planeador
jetfoils=avións de planeador
Jetfoils=Avións de planeador
jihad=guerra santa
Jihad=Guerra santa
jihads=guerras santas
Jihads=Guerras santas
jingle=publicidade musicada
Jingle=Publicidade musicada
jingles=publicidades musicadas
Jingles=Publicidades musicadas
job=emprego
Job=Emprego
jobs=empregos
Jobs=Empregos
jockey=cabaleiro profesional
Jockey=Cabaleiro profesional
jockeys=cabaleiros profesionais
Jockeys=Cabaleiros profesionais
jogging=carreira
Jogging=Carreira
joggings=carreiras
Joggings=Carreiras
# joker=jóquer
# jokers=jóqueres
joystick=barra de control
Joystick=Barra de control
joysticks=barras de control
Joysticks=Barras de control
junkie=drogadicto
Junkie=Drogadicto
junkies=drogadictos
Junkies=Drogadictos
# kabuki=cabúqui
# kabukis=cabúquis
# karaté=caraté
# karatés=caratés
karma=carma
Karma=Carma
karmas=carmas
Karmas=Carmas
# kart=carte
# karts=cartes
# karting=cartismo
# kartings=cartismos
# kayak=caiaque
# kayaks=caiaques
# kendo=quendo
# kendos=quendos
kimono=quimono
Kimono=Quimono
kimonos=quimonos
Kimonos=Quimonos
# kirsch=quirche
# kirschs=quirches
# kiwi=quivi
# kiwis=quivis
kjökkenmödding=concheiro
Kjökkenmödding=Concheiro
kjökkenmöddings=concheiros
Kjökkenmöddings=Concheiros
klaxon=bucina de automóbil
Klaxon=Bucina de automóbil
klaxons=bucinas de automóbil
Klaxons=Bucinas de automóbil
kleenex=pano de papel
Kleenex=Pano de papel
kleenexs=panos de papel
Kleenexs=Panos de papel
knock-out=nocaut
Knock-out=Nocaut
knock-outs=nocautes
Knock-outs=Nocautes
knockout=nocaut
Knockout=Nocaut
knockouts=nocautes
Knockouts=Nocautes
knockout=nocaut
Knockout=Nocaut
knockouts=nocautes
Knockouts=Nocautes
know-how=coñecemento|saber facer
Know-how=Coñecemento|saber facer
know-hows=coñecementos|saber facer
Know-hows=Coñecementos|saber facer
# lamé=lamê
# lamés=lamês
laptop=portátil
Laptop=Portátil
laptops=portátiles
Laptops=Portátiles
layout=disposición
Layout=Disposición
layouts=disposicións
Layouts=Disposicións
leader=líder
Leader=Líder
leaders=líderes
Leaders=Líderes
# leasing=locação financeira
# leasings=locações financeiras
# leasing=locação financeira
# leasings=locações financeiras
# lied=arranxo musical
# lieds=arranxos musicais
light=leve|de baixo valor calórico
Light=Leve|de baixo valor calórico
lights=leves|de baixo valor calórico
Lights=Leves|de baixo valor calórico
link=conexión
Link=Conexión
links=conexións
Links=Conexións
linotype=linótipo
Linotype=Linótipo
linotypes=linótipos
Linotypes=Linótipos
live stream=transmisión en directo
Live stream=Transmisión en directo
live streams=transmisións en directo
Live streams=Transmisións en directo
live streaming=transmisión en directo
Live streaming=Transmisión en directo
live streamings=transmisións en directo
Live streamings=Transmisións en directo
lobby=grupo de presión
Lobby=Grupo de presión
lobbies=grupos de presión
Lobbies=Grupos de presión
look=moda
Look=Moda
looks=modas
Looks=Modas
# lord=lorde
# lords=lordes
# löss=loesse
# lösses=loesses
lounge=sala de espera
Lounge=Sala de espera
lounges=salas de espera
Lounges=Salas de espera
low cost=de baixo custo
Low cost=De baixo custo
low costs=de baixos custos
Low costs=De baixos custos
low-cost=de baixo custo
Low-cost=De baixo custo
low-costs=de baixos custos
Low-costs=De baixos custos
low-profile=discreto
Low-profile=Discreto
low-profiles=discretos
Low-profiles=Discretos
# lycra=licra
# lycras=licras
maçon=mação
Maçon=Mação
maçons=mações
Maçons=Mações
# madonna=madona
# madonnas=madonas
# mah-jong=majongue
# mah-jongs=majongues
mail=enderezo electrónico
Mail=Enderezo electrónico
mails=enderezos electrónicos
Mails=Enderezos electrónicos
mailing=lista de enderezos
Mailing=Lista de enderezos
mailings=listas de enderezos
Mailings=Listas de enderezos
# maillot=maiô
# maillots=maiôs
mainframe=unidade central de procesamento
Mainframe=Unidade central de procesamento
mainframes=unidades centrais de procesamento
Mainframes=Unidades centrais de procesamento
mainstream=corrente principal
Mainstream=Corrente principal
mainstreams=correntes principais
Mainstreams=Correntes principais
maître=xefe
Maître=Xefe
maîtres=xefes
Maîtres=Xefes
make-up=maquillaxe
Make-up=Maquillaxe
make-ups=maquillaxes
Make-ups=Maquillaxes
management=xerencia
Management=Xerencia
managements=xerencias
Managements=Xerencias
manager=xerente|adestrador
Manager=Xerente|adestrador
managers=xerente|adestradores
Managers=Xerente|adestradores
# manette=manete
# manettes=manetes
manif=manifestación
Manif=Manifestación
manifs=manifestacións
Manifs=Manifestacións
maple=sofá
Maple=Sofá
maples=sofás
Maples=Sofás
maquillage=maquillaxe
Maquillage=Maquillaxe
maquillages=maquillaxes
Maquillages=Maquillaxes
marron=marrón
Marron=Marrón
marrons=marróns
Marrons=Marróns
match=desafío
Match=Desafío
matchs=desafíos
Matchs=Desafíos
matching=correspondencia
Matching=Correspondencia
matchings=correspondencias
Matchings=Correspondencias
matinée=sesión da tarde
Matinée=Sesión da tarde
matinées=sesións da tarde
Matinées=Sesións da tarde
mayonnaise=maionesa
Mayonnaise=Maionesa
mayonnaises=maionesas
Mayonnaises=Maionesas
menu=menú
Menu=Menú
menus=menú
Menus=Menú
meeting=manifestación|encontro
Meeting=Manifestación|encontro
meetings=manifestacións|encontros
Meetings=Manifestacións|encontros
mêlée=confusión
Mêlée=Confusión
mêlées=confusións
Mêlées=Confusións
merchandising=divulgación
Merchandising=Divulgación
merchandisings=divulgacións
Merchandisings=Divulgacións
mezzo=medio-soprano
Mezzo=Medio-soprano
mezzos=medio-sopranos
Mezzos=Medio-sopranos
mezzo-soprano=medio-soprano
Mezzo-soprano=Medio-soprano
mezzo-sopranos=medio-sopranos
Mezzo-sopranos=Medio-sopranos
microchip=circuíto integrado
Microchip=Circuíto integrado
microchips=circuítos integrados
Microchips=Circuítos integrados
minibus=miniautobús
Minibus=Miniautobús
minibuses=miniautobúses
Minibuses=Miniautobúses
mise-en-scène=posta en escena
Mise-en-scène=Posta en escena
mise-en-scènes=postas en escena
Mise-en-scènes=Postas en escena
mix=mestura
Mix=Mestura
mixes=mesturas
Mixes=Mesturas
# monokini=monoquíni
# monokinis=monoquínis
motard=motociclista
Motard=Motociclista
motards=motociclistas
Motards=Motociclistas
motherboard=placa-nai
Motherboard=Placa-nai
motherboards=placa-nais
Motherboards=Placa-nais
# motocross=motocrosse
# motocrosses=motocrosses
mouche=muche
Mouche=Muche
mouches=muches
Mouches=Muches
mouse=rato
Mouse=Rato
mouses=ratos
Mouses=Ratos
# mousse=musse
# mousses=musses
# muezzin=muezim
# muezzins=muezins
multitasking=multitarea
Multitasking=Multitarea
naïf=inxenuo
Naïf=Inxenuo
naïfs=inxenuos
Naïfs=Inxenuos
naïf=inxenuo
Naïf=Inxenuo
naïfs=inxenuos
Naïfs=Inxenuos
naïve=inxenuo
Naïve=Inxenuo
naïves=inxenuos
Naïves=Inxenuos
# napperon=naperão
# napperons=naperões
negligé=descuidado
Negligé=Descuidado
negligés=descuidados
Negligés=Descuidados
net=líquido
Net=Líquido
nets=líquidos
Nets=Líquidos
network=cadea
Network=Cadea
networks=cadeas
Networks=Cadeas
newsletter=boletín
Newsletter=Boletín
newsletters=boletíns
Newsletters=Boletíns
noise=barullo
Noise=Barullo
noises=barullos
Noises=Barullos
# non-stop=ininterrupto
# non-stops=ininterruptos
nonsense=absurdo
Nonsense=Absurdo
nonsenses=absurdos
Nonsenses=Absurdos
notebook=portátil
Notebook=Portátil
notebooks=portátiles
Notebooks=Portátiles
note-book=portátil
Note-book=Portátil
note-books=portátiles
Note-books=Portátiles
# nylon=náilon
# nylons=náilons
off-line=sen rede|fóra de liña
Off-line=Sen rede|fóra de liña
off-lines=sen rede|foras de liña
Off-lines=Sen rede|foras de liña
offline=sen rede|fóra de liña
Offline=Sen rede|fóra de liña
offlines=sen rede|foras de liña
Offlines=Sen rede|foras de liña
ombudsman=provedor
Ombudsman=Provedor
ombudsmans=provedores
Ombudsmans=Provedores
omertà=conspiración
Omertà=Conspiración
omertàs=conspiracións
Omertàs=Conspiracións
open=aberto
Open=Aberto
opens=abertos
Opens=Abertos
out=fóra
Out=Fóra
outs=foras
Outs=Foras
outdoor=cartel
Outdoor=Cartel
outdoors=carteis
Outdoors=Carteis
output=resultado
Output=Resultado
outputs=resultados
Outputs=Resultados
outsourcing=contratación externa
Outsourcing=Contratación externa
outsourcings=contratacións externas
Outsourcings=Contratacións externas
overdose=sobredose
Overdose=Sobredose
overdoses=sobredoses
Overdoses=Sobredoses
ozone=ozono
Ozone=Ozono
ozones=ozonos
Ozones=Ozonos
pacemaker=estimulador cardíaco
Pacemaker=Estimulador cardíaco
pacemakers=estimuladores cardíaco
Pacemakers=Estimuladores cardíaco
pack=conxunto|embalaxe
Pack=Conxunto|embalaxe
packs=conxuntos|embalaxes
Packs=Conxuntos|embalaxes
package=embalaxe
Package=Embalaxe
packages=embalaxes
Packages=Embalaxes
# paella=paelha
# paellas=paelhas
# pager=bip
# pagers=bips
palmtop=computador de man
Palmtop=Computador de man
palmtops=computadores de man
Palmtops=Computadores de man
# panne=pane
# pannes=panes
papillon=bolboreta
Papillon=Bolboreta
papillons=bolboretas
Papillons=Bolboretas
paprika=paprica|chile doce
Paprika=Paprica|chile doce
paprikas=paprica|chiles doces
Paprikas=Paprica|chiles doces
parasailing=paracaidismo
Parasailing=Paracaidismo
parasailings=paracaidismos
Parasailings=Paracaidismos
parka=parca
Parka=Parca
parkas=parcas
Parkas=Parcas
parking=parque de estacionamento
Parking=Parque de estacionamento
parkings=parques de estacionamento
Parkings=Parques de estacionamento
parquet=parqué
Parquet=Parqué
parquets=parqués
Parquets=Parqués
part-equipo=tempo parcial
Part-equipo=Tempo parcial
part-equipos=tempo parcial
Part-equipos=Tempo parcial
partenaire=socio
Partenaire=Socio
partenaires=socios
Partenaires=Socios
pase-partout=cuadro
Pase-partout=Cuadro
pase-partouts=cuadros
Pase-partouts=Cuadros
passerelle=pasarela
Passerelle=Pasarela
passerelles=pasarelas
Passerelles=Pasarelas
password=sinal
Password=Sinal
passwords=sinais
Passwords=Sinais
# patchwork=manta de retalhos
# patchworks=mantas de retalhos
# pâté=patê
# pâtés=patês
pedigree=liñaxe
Pedigree=Liñaxe
pedigrees=liñaxes
Pedigrees=Liñaxes
penalty=grande penalidade
Penalty=Grande penalidade
penalties=grandes penalidades
Penalties=Grandes penalidades
per capita=por cabeza
Per capita=Por cabeza
per se=por si mesmo
Per se=Por si mesmo
per si=por si mesmo
Per si=Por si mesmo
performance=desempeño
Performance=Desempeño
performances=desempeños
Performances=Desempeños
performer=artista de escenario|intérprete
Performer=Artista de escenario|intérprete
performers=artistas de escenario|intérpretes
Performers=Artistas de escenario|intérpretes
# physalis=fisális
pick-up=camioneta de caixa aberta
Pick-up=Camioneta de caixa aberta
pick-ups=camionetas de caixa aberta
Pick-ups=Camionetas de caixa aberta
# pickle=picle
# pickles=picles
pickpocket=carteirista
Pickpocket=Carteirista
pickpockets=carteiristas
Pickpockets=Carteiristas
picnic=merenda
Picnic=Merenda
picnics=merendas
Picnics=Merendas
# piercing=pírcingue
# piercings=pírcingues
pipeline=gasoduto
Pipeline=Gasoduto
pipelines=gasodutos
Pipelines=Gasodutos
# pistache=pistácio
# pistaches=pistácios
# pivot=pivô
# pivots=pivôs
# pizza=piza
# pizzas=pizas
# pizzaria=pizaria
# pizzarias=pizarias
# pizzeria=pizaria
# pizzerias=pizarias
# pizzicato=pizicato
# pizzicatos=pizicatos
# pizzicato=pizicato
# pizzicatos=pizicatos
placard=panel
Placard=Panel
placards=paneis
Placards=Paneis
plafond=límite máximo
Plafond=Límite máximo
plafonds=límites máximos
Plafonds=Límites máximos
plastron=plastrón
Plastron=Plastrón
plastrons=plastróns
Plastrons=Plastróns
plateau=meseta
Plateau=Meseta
plateaus=mesetas
Plateaus=Mesetas
play-off=xogo extraordinario
Play-off=Xogo extraordinario
play-offs=xogos extraordinarios
Play-offs=Xogos extraordinarios
playlist=selección musical
Playlist=Selección musical
playlists=seleccións musicais
Playlists=Seleccións musicais
plissê=plisado
Plissê=Plisado
plissês=plisados
Plissês=Plisados
poker=póker
Poker=Póker
pokers=pókeres
Pokers=Pókeres
# polaroid=polaroide
# polaroids=polaroides
# poliban=polibã
# polibans=polibãs
pool=consorcio
Pool=Consorcio
pools=consorcios
Pools=Consorcios
# popcorn=pipoca
# popcorns=pipocas
portfolio=portafolios
Portfolio=Portafolios
portfolios=portafolios
Portfolios=Portafolios
poster=póster
Poster=Póster
posters=pósteres
Posters=Pósteres
# pot-pourri=miscelânea
# pot-pourris=miscelâneas
pouf=pouffe
Pouf=Pouffe
poufs=pouffes
Poufs=Pouffes
poule=pule
Poule=Pule
poules=pules
Poules=Pules
pourboire=punta
Pourboire=Punta
pourboires=puntas
Pourboires=Puntas
ppi=ppp
Ppi=Ppp
#ppp=puntos por polgada
# praliné=pralinê
# pralinés=pralinês
première=estrea
Première=Estrea
premières=estreas
Premières=Estreas
premium=de luxo
Premium=De luxo
prima-donna=prima-dona
Prima-donna=Prima-dona
prima-donnas=prima-donas
Prima-donnas=Prima-donas
print=impresión
Print=Impresión
prints=impresións
Prints=Impresións
prize-money=premio monetario
Prize-money=Premio monetario
prize-moneys=premios monetarios
Prize-moneys=Premios monetarios
publisher=divulgativo
Publisher=Divulgativo
publishers=divulgativos
Publishers=Divulgativos
# pull=pulôver
# pulls=pulôveres
pullover=pulôver
Pullover=Pulôver
pullovers=pulôveres
Pullovers=Pulôveres
punaise=pionese
Punaise=Pionese
punaises=pioneses
Punaises=Pioneses
punch=ponche
Punch=Ponche
punchs=ponches
Punchs=Ponches
putsch=golpe de Estado
Putsch=Golpe de Estado
putschs=golpes de Estado
Putschs=Golpes de Estado
pyrex=pírex
Pyrex=Pírex
pyrexs=pírexes
Pyrexs=Pírexes
raffiné=requintado
Raffiné=Requintado
raffinés=requintados
Raffinés=Requintados
ragoût=xardineira
Ragoût=Xardineira
ragoûts=xardineiras
Ragoûts=Xardineiras
# raid=raide
# raids=raides
# rail=raile
# rails=railes
# rally=rali
# rallies=ralis
ránking=clasificación
Ránking=Clasificación
ránkings=clasificacións
Ránkings=Clasificacións
# rappel=rapel
# rappels=rapeis
rating=cualificación-tipo
Rating=Cualificación-tipo
ratings=cualificacións-tipo
Ratings=Cualificacións-tipo
ratio=razón
Ratio=Razón
ratios=razóns
Ratios=Razóns
# ravioli=ravióis
# raviolis=ravióis
record=marca
Record=Marca
records=marcas
Records=Marcas
recuerdo=recordo
Recuerdo=Recordo
recuerdos=recordo
Recuerdos=Recordo
reengineering=reingeniería
Reengineering=Reingeniería
reengineerings=reingenierías
Reengineerings=Reingenierías
relax=relaxamento
Relax=Relaxamento
relaxs=relaxamentos
Relaxs=Relaxamentos
remake=nova versión
Remake=Nova versión
remakes=novas versións
Remakes=Novas versións
remix=remistura
Remix=Remistura
remixes=remisturas
Remixes=Remisturas
rendez-vous=encontro
Rendez-vous=Encontro
rent-a-car=aluguer de automóbiles
Rent-a-car=Aluguer de automóbiles
rent-a-cars=alugueres de automóbiles
Rent-a-cars=Alugueres de automóbiles
rentrée=regreso
Rentrée=Regreso
rentrées=regresos
Rentrées=Regresos
replay=repetición
Replay=Repetición
replays=repeticións
Replays=Repeticións
resort=estancia
Resort=Estancia
resorts=estancias
Resorts=Estancias
réveillon=pasaxe de ano
Réveillon=Pasaxe de ano
réveillons=pasaxes de ano
Réveillons=Pasaxes de ano
rêverie=devaneio
Rêverie=Devaneio
rêveries=devaneios
Rêveries=Devaneios
rifle=espingarda
Rifle=Espingarda
rifles=espingardas
Rifles=Espingardas
rimmel=máscara
Rimmel=Máscara
rimmels=máscaras
Rimmels=Máscaras
# ring=ringue
# rings=ringues
# ritornello=ritornelo
# ritornellos=ritornelos
roadshow=digresión
Roadshow=Digresión
roadshows=digresións
Roadshows=Digresións
roadster=convertible deportivo
Roadster=Convertible deportivo
roadsters=convertibles deportivos
Roadsters=Convertibles deportivos
robot=robot
Robot=Robot
robots=robots
Robots=Robots
rocket=roquete
Rocket=Roquete
rockets=roquetes
Rockets=Roquetes
# rosé=rosê
# rosés=rosês
# rosé=rosê
# rosés=rosês
# rouge=ruge
# rouges=ruges
roulement=rotación
Roulement=Rotación
roulements=rotacións
Roulements=Rotacións
# roulotte=rulote
# roulottes=rulotes
# round=rolda
# rounds=roldas
# router=encaminhador
# routers=encaminhadores
# rugby=râguebi
# rugbies=râguebis
sage=prudente
Sage=Prudente
sages=prudentes
Sages=Prudentes
sage=prudente
Sage=Prudente
sages=prudentes
Sages=Prudentes
saison=temporada
Saison=Temporada
saisons=temporadas
Saisons=Temporadas
sandwich=sandes
Sandwich=Sandes
sandwichs=sandes
Sandwichs=Sandes
sauté=salteado
Sauté=Salteado
sautés=salteados
Sautés=Salteados
savoir-faire=saber-facer
Savoir-faire=Saber-facer
savoir-faires=saber-facer
Savoir-faires=Saber-facer
savoir-vivre=saber-vivir
Savoir-vivre=Saber-vivir
savoir-vivres=saber-vivir
Savoir-vivres=Saber-vivir
scanner=escáner
Scanner=Escáner
scanners=escáneres
Scanners=Escáneres
scooter=lambreta
Scooter=Lambreta
scooters=lambretas
Scooters=Lambretas
score=resultado
Score=Resultado
scores=resultados
Scores=Resultados
scotch=whisky escocés
Scotch=Whisky escocés
scotchs=whiskies escoceses
Scotchs=Whiskies escoceses
screensaver=protector de pantalla
Screensaver=Protector de pantalla
screensavers=protectores de pantalla
Screensavers=Protectores de pantalla
script=guión
Script=Guión
scripts=guións
Scripts=Guións
# sedan=sedã
# sedans=sedãs
self-government=goberno representativo
Self-government=Goberno representativo
self-governments=gobernos representativos
Self-governments=Gobernos representativos
self-induction=autoindución
Self-induction=Autoindución
self-inductions=autoinducións
Self-inductions=Autoinducións
self-service=autoservizo
Self-service=Autoservizo
self-services=autoservizos
Self-services=Autoservizos
self-service=autoservizo
Self-service=Autoservizo
self-services=autoservizos
Self-services=Autoservizos
serial-killer=asasino en serie
Serial-killer=Asasino en serie
serial-killers=asasinos en serie
Serial-killers=Asasinos en serie
server=servidor
Server=Servidor
servers=servidores
Servers=Servidores
seventies=anos setenta
Seventies=Anos setenta
shake-hand=aperto de man
Shake-hand=Aperto de man
shake-hands=apertos de man
Shake-hands=Apertos de man
shaker=mesturador
Shaker=Mesturador
shakers=mesturadores
Shakers=Mesturadores
shampoo=xampú
Shampoo=Xampú
shampoos=xampú
Shampoos=Xampú
# shantung=xantungue
# shantungs=xantungues
share=cota de audiencias
Share=Cota de audiencias
shares=cotas de audiencias
Shares=Cotas de audiencias
sheik=xeque
Sheik=Xeque
sheiks=xeques
Sheiks=Xeques
sheriff=xerife
Sheriff=Xerife
sheriffs=xerifes
Sheriffs=Xerifes
shocking=chocante
Shocking=Chocante
shockings=chocantes
Shockings=Chocantes
shopping=centro comercial
Shopping=Centro comercial
shoppings=centros comerciais
Shoppings=Centros comerciais
short=curtametraxe
Short=Curtametraxe
shorts=curtametraxes
Shorts=Curtametraxes
# shorts=calções
show=divertimento
Show=Divertimento
shows=divertimentos
Shows=Divertimentos
show-off=exhibicionismo
Show-off=Exhibicionismo
show-offs=exhibicionismos
Show-offs=Exhibicionismos
showbiz=actividades do espectáculo
Showbiz=Actividades do espectáculo
showbizs=actividades de espectáculo
Showbizs=Actividades de espectáculo
showman=presentador
Showman=Presentador
showmans=presentadores
Showmans=Presentadores
showroom=salón de exposicións
Showroom=Salón de exposicións
showrooms=salóns de exposicións
Showrooms=Salóns de exposicións
# sikh=sique
# sikhs=siques
# sinfonetta=sinfonieta
# sinfonettas=sinfonietas
single=cuarto individual
Single=Cuarto individual
singles=cuartos individuais
Singles=Cuartos individuais
sit-in=protesta
Sit-in=Protesta
sit-ins=protestas
Sit-ins=Protestas
sitcom=serie cómica
Sitcom=Serie cómica
sitcoms=series cómicas
Sitcoms=Series cómicas
site=sitio web
Site=Sitio web
sites=sitios web
Sites=Sitios web
sixties=anos sesenta
Sixties=Anos sesenta
sketch=esbozo
Sketch=Esbozo
sketchs=esbozos
Sketchs=Esbozos
ski=esquí
Ski=Esquí
skis=esquís
Skis=Esquís
skiff=ataúde
Skiff=Ataúde
skiffs=ataúdes
Skiffs=Ataúdes
skin=cabeza rapada
Skin=Cabeza rapada
skins=cabezas rapadas
Skins=Cabezas rapadas
skinhead=cabeza rapada
Skinhead=Cabeza rapada
skinheads=cabezas rapadas
Skinheads=Cabezas rapadas
slang=xerga
Slang=Xerga
slangs=xergas
Slangs=Xergas
slide=diapositiva
Slide=Diapositiva
slides=diapositivas
Slides=Diapositivas
slow=lento
Slow=Lento
slows=lentos
Slows=Lentos
sniper=tirador furtivo
Sniper=Tirador furtivo
snipers=tiradores furtivos
Snipers=Tiradores furtivos
sniper=tirador furtivo
Sniper=Tirador furtivo
snipers=tiradores furtivos
Snipers=Tiradores furtivos
sobriquet=alcume
Sobriquet=Alcume
sobriquets=alcumes
Sobriquets=Alcumes
soccer=fútbol
Soccer=Fútbol
# socquette=soquete
# socquettes=soquetes
soft=brando
Soft=Brando
softs=brandos
Softs=Brandos
# softball=softebol
soi-disant=pretencioso
Soi-disant=Pretencioso
soi-disants=pretenciosos
Soi-disants=Pretenciosos
soirée=matinee
Soirée=Matinee
soirées=matinee
Soirées=Matinee
sombrero=sombreiro
Sombrero=Sombreiro
sombreros=sombreiros
Sombreros=Sombreiros
# soufflé=suflé
# soufflés=suflés
souplesse=flexibilidade
Souplesse=Flexibilidade
souplesses=flexibilidades
Souplesses=Flexibilidades
# soutien=sutiã
# soutiens=sutiãs
# soutien-gorge=sutiã
# soutien-gorges=sutiãs
souvenir=recordo
Souvenir=Recordo
souvenirs=recordos
Souvenirs=Recordos
# spaghetti=esparguete
# spaghettis=esparguetes
speaker=presidente de parlamento
Speaker=Presidente de parlamento
speakers=presidentes de parlamento
Speakers=Presidentes de parlamento
speed=estimulación
Speed=Estimulación
speeds=estimulacións
Speeds=Estimulacións
spleen=tedio
Spleen=Tedio
spleens=tedios
Spleens=Tedios
spoiler=estabilizador
Spoiler=Estabilizador
spoilers=estabilizadores
Spoilers=Estabilizadores
sponsor=patrocinador
Sponsor=Patrocinador
sponsors=patrocinadores
Sponsors=Patrocinadores
sport=deporte
Sport=Deporte
sports=deportes
Sports=Deportes
# sporting=deportivo
sportings=deportivos
Sportings=Deportivos
sportsman=deportista
Sportsman=Deportista
sportsmans=deportistas
Sportsmans=Deportistas
sportswear=roupa de deporte
Sportswear=Roupa de deporte
sportswears=roupas de deporte
Sportswears=Roupas de deporte
spray=vaporización
Spray=Vaporización
sprays=vaporizacións
Sprays=Vaporizacións
staff=equipo de traballo
Staff=Equipo de traballo
staffs=equipos de traballo
Staffs=Equipos de traballo
standard=patrón
Standard=Patrón
standards=patróns
Standards=Patróns
standard=patrón
Standard=Patrón
standards=patróns
Standards=Patróns
standby=posición de espera|espera
Standby=Posición de espera|espera
standbys=posicións de espera|esperas
Standbys=Posicións de espera|esperas
stand-by=posición de espera|espera
Stand-by=Posición de espera|espera
stand-bys=posicións de espera|esperas
Stand-bys=Posicións de espera|esperas
star=estrela
Star=Estrela
stars=estrelas
Stars=Estrelas
station=camioneta
Station=Camioneta
stations=camionetas
Stations=Camionetas
status=estatuto
Status=Estatuto
stencil=estencilo
Stencil=Estencilo
stencils=estencilos
Stencils=Estencilos
stereo=estereofónico
Stereo=Estereofónico
stereos=estereofónicos
Stereos=Estereofónicos
stereo=estereofónico
Stereo=Estereofónico
stereos=estereofónicos
Stereos=Estereofónicos
stock=estoque
Stock=Estoque
stocks=estoques
Stocks=Estoques
street=rúa
Street=Rúa
streets=rúas
Streets=Rúas
strogonoff=estrogonofe
Strogonoff=Estrogonofe
strogonoffs=estrogonofes
Strogonoffs=Estrogonofes
# suite=suíte
# suites=suítes
# surf=surfe
# surfs=surfes
# surfer=surfista
# surfers=surfistas
surmenage=fatiga intelectual
Surmenage=Fatiga intelectual
surmenages=fatigas intelectuais
Surmenages=Fatigas intelectuais
# tablette=tablete
# tablettes=tabletes
# tablier=tabliê
# tabliers=tabliês
tailleur=conxunto sae-chaqueta
Tailleur=Conxunto sae-chaqueta
tailleurs=conxuntos sae-chaqueta
Tailleurs=Conxuntos sae-chaqueta
take-off=despegue vertical
Take-off=Despegue vertical
take-offs=despegues verticales
Take-offs=Despegues verticales
target=obxectivo
Target=Obxectivo
targets=obxectivos
Targets=Obxectivos
# tarot=tarô
# tarots=tarôs
tattoo=tatuaxe
Tattoo=Tatuaxe
tattoos=tatuaxes
Tattoos=Tatuaxes
tax-free=eximo de imposto
Tax-free=Eximo de imposto
team=equipo
Team=Equipo
teams=equipos
Teams=Equipos
teenager=adolescente
Teenager=Adolescente
teenagers=adolescentes
Teenagers=Adolescentes
# telefax=telefaxe
# telefaxs=telefaxes
# teleski=telesqui
# teleskis=telesquis
# terrier=terriê
# terriers=terriês
tête-á-tête=fronte-a-fronte
Tête-á-tête=Fronte-a-fronte
tête-á-têtes=fronte-a-frontes
Tête-á-têtes=Fronte-a-frontes
thesaurus=tesauro
Thesaurus=Tesauro
think-tank=círculo de reflexión
Think-tank=Círculo de reflexión
think-tanks=círculos de reflexión
Think-tanks=Círculos de reflexión
thirties=anos trinta
Thirties=Anos trinta
# thriller=tríler
# thrillers=tríleres
ticket=billete
Ticket=Billete
tickets=billetes
Tickets=Billetes
timer=temporizador
Timer=Temporizador
timers=temporizadores
Timers=Temporizadores
# timing=calendarização|oportunidade
# timings=calendarização|oportunidades
toast=toste
Toast=Toste
toasts=tostes
Toasts=Tostes
toboggan=tobogán
Toboggan=Tobogán
toboggans=tobogáns
Toboggans=Tobogáns
toilette=casa de baño
Toilette=Casa de baño
toilettes=casas de baño
Toilettes=Casas de baño
# topless=toplesse
# toplesses=toplesses
# tory=tóri
# tories=tóris
tour=digresión
Tour=Digresión
tours=digresións
Tours=Digresións
tournée=sesión itinerante|digresión
Tournée=Sesión itinerante|digresión
tournées=sesións itinerante|digresións
Tournées=Sesións itinerante|digresións
training=traxe de adestramento
Training=Traxe de adestramento
trainings=traxes de adestramento
Trainings=Traxes de adestramento
tranche=porción
Tranche=Porción
tranches=porcións
Tranches=Porcións
# tricot=tricô
# tricots=tricôs
trip=viaxe
Trip=Viaxe
trips=viaxes
Trips=Viaxes
troika=troica
Troika=Troica
troikas=troicas
Troikas=Troicas
trolleybus=trolebús
Trolleybus=Trolebús
trolleybuses=trolebúses
Trolleybuses=Trolebúses
trottinette=trotineta
Trottinette=Trotineta
trottinettes=trotinetas
Trottinettes=Trotinetas
trottoir=paseo
Trottoir=Paseo
trottoirs=paseos
Trottoirs=Paseos
# troupe=trupe
# troupes=trupes
# trousse=trusse
# trousses=trusses
trust=asociación financeira
Trust=Asociación financeira
trusts=asociacións financeiras
Trusts=Asociacións financeiras
turnover=taxa de rotación
Turnover=Taxa de rotación
turnovers=taxas de rotación
Turnovers=Taxas de rotación
tweed=tecido escocés
Tweed=Tecido escocés
tweeds=tecidos escoceses
Tweeds=Tecidos escoceses
twenties=anos vinte
Twenties=Anos vinte
# tzar=czar
# tzars=czares
ultra high definition=ultra alta definición
Ultra high definition=Ultra alta definición
Ultra High Definition=Ultra Alta Definición
umlaut=metafonía
Umlaut=Metafonía
umlauts=metafonías
Umlauts=Metafonías
underwear=roupa interior
Underwear=Roupa interior
underwears=roupas interiores
Underwears=Roupas interiores
unisex=unisex
Unisex=Unisex
unisexs=unisexos
Unisexs=Unisexos
up-cho-date=actualizado
Up-cho-date=Actualizado
up-cho-dates=actualizados
Up-cho-dates=Actualizados
upgrade=promoción
Upgrade=Promoción
upgrades=promocións
Upgrades=Promocións
valise=maleta de man
Valise=Maleta de man
valises=maletas de man
Valises=Maletas de man
# vamp=vampe
# vamps=vampes
# van=camioneta
# vans=camionetas
vendetta=vinganza
Vendetta=Vinganza
vendettas=vinganzas
Vendettas=Vinganzas
very-light=foguete
Very-light=Foguete
very-lights=foguetes
Very-lights=Foguetes
versus=contra
Versus=Contra
# videoclip=teledisco
# videoclips=telediscos
videogame=xogo de vídeo
Videogame=Xogo de vídeo
videogames=xogos de vídeo
Videogames=Xogos de vídeo
videotape=gravadora de video
Videotape=Gravadora de video
videotapes=gravadoras de video
Videotapes=Gravadoras de video
videowall=pantalla xigante
Videowall=Pantalla xigante
videowalls=pantallas xigantes
Videowalls=Pantallas xigantes
viking=viquingo
Viking=Viquingo
vikings=viquingos
Vikings=Viquingos
vinaigrette=vinagreta
Vinaigrette=Vinagreta
vinaigrettes=vinagretas
Vinaigrettes=Vinagretas
vis-á-vis=fronte-a-fronte
Vis-á-vis=Fronte-a-fronte
vis-á-vises=fronte-a-frontes
Vis-á-vises=Fronte-a-frontes
vison=pel de marta
Vison=Pel de marta
# vodka=vodca
# vodkas=vodcas
voice-mail=caixa postal de voz
Voice-mail=Caixa postal de voz
voice-mails=caixas postais de voz
Voice-mails=Caixas postais de voz
voile=manto
Voile=Manto
voiles=mantos
Voiles=Mantos
volley=volei
Volley=Volei
volleys=voleis
Volleys=Voleis
voucher=vale
Voucher=Vale
vouchers=vales
Vouchers=Vales
walkman=lector de casetes portátil
Walkman=Lector de casetes portátil
walkmans=lectores de casetes portátiles
Walkmans=Lectores de casetes portátiles
water-closet=casa de baño
Water-closet=Casa de baño
water-closets=casas de baño
Water-closets=Casas de baño
water-polo=polo acuático
Water-polo=Polo acuático
watergate=escándalo de natureza política
Watergate=Escándalo de natureza política
watergates=escándalos de natureza política
Watergates=Escándalos de natureza política
waterproof=á proba de auga
Waterproof=Á proba de auga
waterproof=á proba de auga
Waterproof=Á proba de auga
weekend=fin de semana
Weekend=Fin de semana
weekends=fins de semana
Weekends=Fins de semana
# whiskey=uísque
# whiskeys=uísques
# whisky=uísque
# whiskies=uísques
windsurf=prancha á vela
Windsurf=Prancha á vela
windsurfs=pranchas á vela
Windsurfs=Pranchas á vela
winner=vencedor
Winner=Vencedor
winners=vencedores
Winners=Vencedores
workaholic=viciado no traballo
Workaholic=Viciado no traballo
workaholics=viciados no traballo
Workaholics=Viciados no traballo
workaholic=viciado no traballo
Workaholic=Viciado no traballo
workaholics=viciados no traballo
Workaholics=Viciados no traballo
workshop=taller de traballo
Workshop=Taller de traballo
workshops=talleres de traballo
Workshops=Talleres de traballo
workstation=estación de traballo
Workstation=Estación de traballo
workstations=estacións de traballo
Workstations=Estacións de traballo
yacht=iate
Yacht=Iate
yachts=iates
Yachts=Iates
# yankee=ianque
# yankees=ianques
# yard=jarda
# yards=jardas
# yé-yé=ié-ié
# yé-yés=ié-iés
# yen=ien
# yens=iens
# yiddish=ídiche
# yiddishs=ídiches
yield=rendemento
Yield=Rendemento
yields=rendementos
Yields=Rendementos
yod=iode
Yod=Iode
yods=iodes
Yods=Iodes
yoga=ioga
Yoga=Ioga
yogas=iogas
Yogas=Iogas
zip=fecho de correr
Zip=Fecho de correr
zips=fechos de correr
Zips=Fechos de correr
# zloty=zlóti
# zloties=zlótis
zombie=morto-vivo
Zombie=Morto-vivo
zombies=mortos-vivos
Zombies=Mortos-vivos
zomby=morto-vivo
Zomby=Morto-vivo
zoom=ampliación
Zoom=Ampliación
zooms=ampliacións
