# English multiwords file used for EnglishHybridDisambiguator
#
ahead of	IN
Ahead of	IN
as far as	IN
As far as	IN
aside from	IN
Aside from	IN
as of	IN
As of	IN
as soon as possible 	RB
As soon as possible 	RB
because of	IN
Because of	IN
by means of	IN
By means of	IN
even less	RB
Even less	RB
even more	RB
Even more	RB
except for	IN
Except for	IN
far from	IN
Far from	IN
in accordance with	IN
In accordance with	IN
in addition to	IN
In addition to	IN
in a while	RB
In a while	RB
in case of	IN
In case of	IN
in front of	IN
In front of	IN
in lieu of	IN
In lieu of	IN
in perhaps	IN
In perhaps	IN
in place of	IN
In place of	IN
in spite of	IN
In spite of	IN
instead of	IN
Instead of	IN
just a bit	RB
Just a bit	RB
next to	IN
Next to	IN
on account of	IN
On account of	IN
on behalf of	IN
On behalf of	IN
on top of	IN
On top of	IN
out of	IN
Out of	IN
prior to	IN
Prior to	IN
regardless of	IN
Regardless of	IN
right here	RB
Right here	RB
right now	RB
Right now	RB
right there	RB
Right there	RB
with regard to	IN
####################################################
###            Latim expressions                 ###
####################################################
# Partially from Catalan multiword.txt files - 08-11-2016
ad hoc	RB
ab initio	RB
ab intestato	RB
ab ovo	RB
ad eternum	RB
ad hominem	JJ
ad interim	RB
ad lib	RB
ad libitum	RB
ad litem	RB
ad litteram	RB
ad nauseam	RB
ad quadrantum	RB
ad triangulum	RB
ad valorem	RB
alma mater	NN
cum laude	JJ
honoris causa	JJ
summa cum laude	JJ
magna cum laude	JJ
egregia cum laude	JJ
maxima cum laude	JJ
et al	RB
et alii	RB
et alia	RB
in aeternum	RB
in albis	RB
in anima vili	RB
in articulo mortis	RB
in crescendo	RB
in extenso	RB
in extremis	RB
in fieri	RB
in fraganti	RB
in illo tempore	RB
in memoriam	IN
in partibus	JJ
in partibus infidelium	RB
in pectore	RB
in perpetuum	RB
in promptu	RB
in puribus	RB
in situ	RB
in solidum	RB
in vitro	RB
in vivo	RB
ipsis verbis	RB
ipso facto	RB
ipso jure	RB
mutatis mutandis	RB
numerus clausus	NN
nota bene	NN:U
peccata minuta	NN:U
tutti quanti	RB
vade retro	NN:U

###########################################################
##### Species imported from Portuguese multiwords.txt #####
###########################################################

Abrus precatorius	NNP
Acacia baileyana	NNP
Acacia cyanophylla	NNP
Acacia cyclops	NNP
Acacia dealbata	NNP
Acacia decurrens	NNP
Acacia karroo	NNP
Acacia longifolia	NNP
Acacia mearnsii	NNP
Acacia melanoxylon	NNP
Acacia pycnantha	NNP
Acacia retinodes	NNP
Acacia sp	NNP
Acacia spp	NNP
Acanthamoeba castellanii	NNP
Acanthamoeba sp	NNP
Acanthamoeba spp	NNP
Acetobacter aurantius	NNP
Acetobacter sp	NNP
Acetobacter spp	NNP
Acinetobacter baumannii	NNP
Acinetobacter sp	NNP
Acinetobacter spp	NNP
Aconitum ferox	NNP
Acridotheres cristatellus	NNP
Acridotheres sp	NNP
Acridotheres spp	NNP
Acridotheres tristis	NNP
Actaea spicata	NNP
Actinomyces israelii	NNP
Actinomyces sp	NNP
Actinomyces spp	NNP
Aedes aegypti	NNP
Aedes albopictus	NNP
Aedes sp	NNP
Aedes spp	NNP
Aegilops sp	NNP
Aegilops spp	NNP
Aegilops tauschii	NNP
Agave americana	NNP
Agave sp	NNP
Agave spp	NNP
Agrobacterium radiobacter	NNP
Agrobacterium sp	NNP
Agrobacterium spp	NNP
Agrobacterium tumefaciens	NNP
Ailanthus altissima	NNP
Ailanthus sp	NNP
Ailanthus spp	NNP
Albizia lophanta	NNP
Albizia sp	NNP
Albizia spp	NNP
Albugo candidalbugo	NNP
Albugo sp	NNP
Albugo spp	NNP
Alopochen aegyptiacus	NNP
Alopochen sp	NNP
Alopochen spp	NNP
Amadina fasciata	NNP
Amadina sp	NNP
Amadina spp	NNP
Amandava amandava	NNP
Amandava sp	NNP
Amandava spp	NNP
Amandava subflava	NNP
Amanita phalloides	NNP
Amborella sp	NNP
Amborella spp	NNP
Amborella trichopodarabidopsis	NNP
Amphimedon queenslandicanopheles	NNP
Amphimedon sp	NNP
Amphimedon spp	NNP
Anaplasma phagocytophilum	NNP
Anaplasma sp	NNP
Anaplasma spp	NNP
Anas platyrhynchos	NNP
Anas sp	NNP
Anas spp	NNP
Angomonas deanei	NNP
Angomonas sp	NNP
Angomonas spp	NNP
Anopheles gambiae	NNP
Anopheles sp	NNP
Anopheles spp	NNP
Anser indicus	NNP
Anser sp	NNP
Anser spp	NNP
Aphanomyces astaci	NNP
Aphanomyces invadans	NNP
Aphanomyces sp	NNP
Aphanomyces spp	NNP
Apis mellifera	NNP
Apis melliferatta	NNP
Apis sp	NNP
Apis spp	NNP
Apodemus sp	NNP
Apodemus spp	NNP
Apodemus sylvaticus	NNP
Aquila chrysaetos	NNP
Aquila sp	NNP
Aquila spp	NNP
Ara sp	NNP
Ara spp	NNP
Aratinga acuticaudata	NNP
Aratinga sp	NNP
Aratinga spp	NNP
Arctotheca calendula	NNP
Arctotheca sp	NNP
Arctotheca spp	NNP
Arundo donax	NNP
Arundo sp	NNP
Arundo spp	NNP
Arvicola sapidus	NNP
Arvicola sp	NNP
Arvicola spp	NNP
Arvicola terrestris	NNP
Astyanax mexicanus	NNP
Astyanax sp	NNP
Astyanax spp	NNP
Aureococcus anophagefferens	NNP
Aureococcus sp	NNP
Aureococcus spp	NNP
Azolla caroliniana	NNP
Azolla filiculoides	NNP
Azolla sp	NNP
Azolla spp	NNP
Azorhizobium caulinodans	NNP
Azorhizobium sp	NNP
Azorhizobium spp	NNP
Azotobacter sp	NNP
Azotobacter spp	NNP
Azotobacter vinelandii	NNP
Babesia bigemina	NNP
Babesia bovis	NNP
Babesia microti	NNP
Babesia sp	NNP
Babesia spp	NNP
Bacillus anthracis	NNP
Bacillus brevis	NNP
Bacillus cereus	NNP
Bacillus fusiformis	NNP
Bacillus licheniformis	NNP
Bacillus megaterium	NNP
Bacillus mycoides	NNP
Bacillus sp	NNP
Bacillus spp	NNP
Bacillus stearothermophilus	NNP
Bacillus subtilis	NNP
Bacillus subtilis	NNP
Bacteroides fragilis	NNP
Bacteroides gingivalis	NNP
Bacteroides melaninogenicus	NNP
Bacteroides sp	NNP
Bacteroides spp	NNP
Balaena mysticetus	NNP
Balaena sp	NNP
Balaena spp	NNP
Balaenoptera acutorostrata	NNP
Balaenoptera bonaerensis	NNP
Balaenoptera borealis	NNP
Balaenoptera brydei	NNP
Balaenoptera edeni	NNP
Balaenoptera musculus	NNP
Balaenoptera omurai	NNP
Balaenoptera physalus	NNP
Balaenoptera sp	NNP
Balaenoptera spp	NNP
Barbastella barbastellus	NNP
Barbastella sp	NNP
Barbastella spp	NNP
Bartonella henselae	NNP
Bartonella quintana	NNP
Bartonella sp	NNP
Bartonella spp	NNP
Belgica antarctica	NNP
Belgica sp	NNP
Belgica spp	NNP
Berardius arnuxii	NNP
Berardius bairdii	NNP
Berardius sp	NNP
Berardius spp	NNP
Beta sp	NNP
Beta spp	NNP
Beta vulgaris	NNP
Bigelowiella natans	NNP
Bigelowiella sp	NNP
Bigelowiella spp	NNP
Blastocystis hominis	NNP
Blastocystis sp	NNP
Blastocystis spp	NNP
Bodo saltans	NNP
Bodo sp	NNP
Bodo spp	NNP
Bombus impatiens	NNP
Bombus sp	NNP
Bombus spp	NNP
Bombyx mori	NNP
Bombyx sp	NNP
Bombyx spp	NNP
Bordetella bronchiseptica	NNP
Bordetella pertussis	NNP
Bordetella sp	NNP
Bordetella spp	NNP
Borrelia burgdorferi	NNP
Borrelia sp	NNP
Borrelia spp	NNP
Bos sp	NNP
Bos spp	NNP
Bos taurus	NNP
Brachypodium distachyon	NNP
Brachypodium sp	NNP
Brachypodium spp	NNP
Brassica napus	NNP
Brassica oleracea	NNP
Brassica rapa	NNP
Brassica sp	NNP
Brassica spp	NNP
Brucella abortus	NNP
Brucella melitensis	NNP
Brucella sp	NNP
Brucella spp	NNP
Brucella suis	NNP
Brugia malayi	NNP
Brugia sp	NNP
Brugia spp	NNP
Bulweria bulwerii	NNP
Bulweria sp	NNP
Bulweria spp	NNP
Burkholderia cepacia	NNP
Burkholderia mallei	NNP
Burkholderia pseudomallei	NNP
Burkholderia sp	NNP
Burkholderia spp	NNP
Buteo buteo	NNP
Buteo sp	NNP
Buteo spp	NNP
Cacatua goffini	NNP
Cacatua sp	NNP
Cacatua spp	NNP
Caenorhabditis brenneri	NNP
Caenorhabditis briggsae	NNP
Caenorhabditis elegans	NNP
Caenorhabditis japonicaenorhabditis	NNP
Caenorhabditis sp	NNP
Caenorhabditis spp	NNP
Caladium seguinium	NNP
Callithrix jacchus	NNP
Callithrix sp	NNP
Callithrix spp	NNP
Calymmatobacterium granulomatis	NNP
Calymmatobacterium sp	NNP
Calymmatobacterium spp	NNP
Campylobacter coli	NNP
Campylobacter fetus	NNP
Campylobacter jejuni	NNP
Campylobacter pylori	NNP
Campylobacter sp	NNP
Campylobacter spp	NNP
Canis lupus	NNP
Canis sp	NNP
Canis spp	NNP
Caperea marginata	NNP
Caperea sp	NNP
Caperea spp	NNP
Capitella sp	NNP
Capitella spp	NNP
Capitella teleta	NNP
Capra pyrenaica	NNP
Capra sp	NNP
Capra spp	NNP
Capreolus capreolus	NNP
Capreolus sp	NNP
Capreolus spp	NNP
Capsaspora owczarzaki	NNP
Capsaspora sp	NNP
Capsaspora spp	NNP
Carassius auratus	NNP
Carassius sp	NNP
Carassius spp	NNP
Carbo medicinalis	NNP
Carcharias sp	NNP
Carcharias spp	NNP
Carcharias taurus	NNP
Carcharodon carcharias	NNP
Carcharodon sp	NNP
Carcharodon spp	NNP
Carduelis carduelis	NNP
Carduelis chloris	NNP
Carduelis sp	NNP
Carduelis spp	NNP
Carpobrotus edulis	NNP
Carpobrotus sp	NNP
Carpobrotus spp	NNP
Castanea sativa	NNP
Castanea sp	NNP
Castanea spp	NNP
Castor fiber	NNP
Castor sp	NNP
Castor spp	NNP
Cavia porcellus	NNP
Cavia sp	NNP
Cavia spp	NNP
Cephalorhynchus commersonii	NNP
Cephalorhynchus eutropia	NNP
Cephalorhynchus heavisidii	NNP
Cephalorhynchus hectori	NNP
Cephalorhynchus sp	NNP
Cephalorhynchus spp	NNP
Ceratotherium simum	NNP
Ceratotherium sp	NNP
Ceratotherium spp	NNP
Cervus elaphus	NNP
Cervus sp	NNP
Cervus spp	NNP
Chlamydia sp	NNP
Chlamydia spp	NNP
Chlamydia trachomatis	NNP
Chlamydomonas reinhardtii	NNP
Chlamydomonas sp	NNP
Chlamydomonas spp	NNP
Chlamydophila pneumoniae	NNP
Chlamydophila psittaci	NNP
Chlamydophila sp	NNP
Chlamydophila spp	NNP
Chlorocebus sabaeus	NNP
Chlorocebus sp	NNP
Chlorocebus spp	NNP
Choloepus hoffmanni	NNP
Choloepus sp	NNP
Choloepus spp	NNP
Chondrus crispus	NNP
Chondrus sp	NNP
Chondrus spp	NNP
Chroomonas mesostigmatica	NNP
Chroomonas sp	NNP
Chroomonas spp	NNP
Chrysemys pictailuropoda	NNP
Chrysemys sp	NNP
Chrysemys spp	NNP
Cichlasoma facetum	NNP
Cichlasoma sp	NNP
Cichlasoma spp	NNP
Ciconia ciconia	NNP
Ciconia sp	NNP
Ciconia spp	NNP
Cicuta maculata	NNP
Ciona intestinalis	NNP
Ciona savignyi	NNP
Ciona sp	NNP
Ciona spp	NNP
Claviceps purpurea	NNP
Clematis vitalba	NNP
Clostridium botulinum	NNP
Clostridium difficile	NNP
Clostridium perfringens	NNP
Clostridium sp	NNP
Clostridium spp	NNP
Clostridium tetani	NNP
Cocculus indicus	NNP
Columba livia	NNP
Columba sp	NNP
Columba spp	NNP
Columbina passerina	NNP
Columbina sp	NNP
Columbina spp	NNP
Convallaria majalis	NNP
Conyza bonariensis	NNP
Conyza sp	NNP
Conyza spp	NNP
Corbicula fluminea	NNP
Corbicula sp	NNP
Corbicula spp	NNP
Cortaderia selloana	NNP
Cortaderia sp	NNP
Cortaderia spp	NNP
Corynebacterium diphtheriae	NNP
Corynebacterium fusiforme	NNP
Corynebacterium parvum	NNP
Corynebacterium sp	NNP
Corynebacterium spp	NNP
Coxiella burnetii	NNP
Coxiella sp	NNP
Coxiella spp	NNP
Crassostrea gigas	NNP
Crassostrea sp	NNP
Crassostrea spp	NNP
Cricetulus griseus	NNP
Cricetulus sp	NNP
Cricetulus spp	NNP
Crocidura russula	NNP
Crocidura sp	NNP
Crocidura spp	NNP
Crocidura suaveolens	NNP
Cryptomonas paramecium	NNP
Cryptomonas sp	NNP
Cryptomonas spp	NNP
Cryptosporidium muris	NNP
Cryptosporidium parvum	NNP
Cryptosporidium sp	NNP
Cryptosporidium spp	NNP
Culex quinquefasciatus	NNP
Culex sp	NNP
Culex spp	NNP
Cupressus lusitanica	NNP
Cupressus sp	NNP
Cupressus spp	NNP
Cyanidioschyzon merolae	NNP
Cyanidioschyzon sp	NNP
Cyanidioschyzon spp	NNP
Cyanollseus patagonus	NNP
Cyanollseus sp	NNP
Cyanollseus spp	NNP
Cyclamen europaeum	NNP
Cygnus atratus	NNP
Cygnus sp	NNP
Cygnus spp	NNP
Cyprinus carpio	NNP
Cyprinus sp	NNP
Cyprinus spp	NNP
Cystophora cristata	NNP
Cystophora sp	NNP
Cystophora spp	NNP
Dama dama	NNP
Dama sp	NNP
Dama spp	NNP
Danaus plexippus	NNP
Danaus sp	NNP
Danaus spp	NNP
Danio rerio	NNP
Danio sp	NNP
Danio spp	NNP
Daphnia pulex	NNP
Daphnia sp	NNP
Daphnia spp	NNP
Dasypus novemcinctus	NNP
Dasypus sp	NNP
Dasypus spp	NNP
Datura sp	NNP
Datura spp	NNP
Datura stramonium	NNP
Delichon sp	NNP
Delichon spp	NNP
Delichon urbicum	NNP
Delphinapterus leucas	NNP
Delphinapterus sp	NNP
Delphinapterus spp	NNP
Delphinium staphisagria	NNP
Delphinus capensis	NNP
Delphinus delphis	NNP
Delphinus sp	NNP
Delphinus spp	NNP
Delphinus tropicalis	NNP
Dendroctonus ponderosae	NNP
Dendroctonus sp	NNP
Dendroctonus spp	NNP
Dictyostelium discoideum	NNP
Dictyostelium fasciculatum	NNP
Dictyostelium lacteum	NNP
Dictyostelium purpureum	NNP
Dictyostelium sp	NNP
Dictyostelium spp	NNP
Dipodomys ordii	NNP
Dipodomys sp	NNP
Dipodomys spp	NNP
Drosophila ananassae	NNP
Drosophila erecta	NNP
Drosophila grimshawi	NNP
Drosophila melanogaster	NNP
Drosophila mojavensis	NNP
Drosophila persimilis	NNP
Drosophila pseudoobscura	NNP
Drosophila sechellia	NNP
Drosophila simulans	NNP
Drosophila sp	NNP
Drosophila spp	NNP
Drosophila virilis	NNP
Drosophila willistoni	NNP
Drosophila yakuba	NNP
Dryopteris filix-mas	NNP
Dwarf minke	NNP
Dwarf sp	NNP
Dwarf spp	NNP
Echinops sp	NNP
Echinops spp	NNP
Echinops telfairi	NNP
Ehrlichia chaffeensis	NNP
Ehrlichia sp	NNP
Ehrlichia spp	NNP
Eichhornia crassipes	NNP
Eichhornia sp	NNP
Eichhornia spp	NNP
Eimeria acervulina	NNP
Eimeria brunetti	NNP
Eimeria maxima	NNP
Eimeria mitis	NNP
Eimeria necatrix	NNP
Eimeria praecox	NNP
Eimeria sp	NNP
Eimeria spp	NNP
Eimeria tenella	NNP
Eliomys quercinus	NNP
Eliomys sp	NNP
Eliomys spp	NNP
Elodea canadensis	NNP
Elodea sp	NNP
Elodea spp	NNP
Emberiza calandra	NNP
Emberiza sp	NNP
Emberiza spp	NNP
Emiliania huxleyi	NNP
Emiliania sp	NNP
Emiliania spp	NNP
Entamoeba dispar	NNP
Entamoeba histolytica	NNP
Entamoeba invadens	NNP
Entamoeba nuttalli	NNP
Entamoeba sp	NNP
Entamoeba spp	NNP
Enterobacter cloacae	NNP
Enterobacter sp	NNP
Enterobacter spp	NNP
Enterococcus avium	NNP
Enterococcus durans	NNP
Enterococcus faecalis	NNP
Enterococcus faecium	NNP
Enterococcus galllinarum	NNP
Enterococcus maloratus	NNP
Enterococcus sp	NNP
Enterococcus spp	NNP
Eos bornea	NNP
Eos sp	NNP
Eos spp	NNP
Eptesicus serotinus	NNP
Eptesicus sp	NNP
Eptesicus spp	NNP
Equus caballus	NNP
Equus sp	NNP
Equus spp	NNP
Erigeron karvinskianus	NNP
Erigeron sp	NNP
Erigeron spp	NNP
Erignathus barbatus	NNP
Erignathus sp	NNP
Erignathus spp	NNP
Erinaceus europaeus	NNP
Erinaceus sp	NNP
Erinaceus spp	NNP
Eriocheir sinensis	NNP
Eriocheir sp	NNP
Eriocheir spp	NNP
Erithacus rubecula	NNP
Erithacus sp	NNP
Erithacus spp	NNP
Eryngium pandanifolium	NNP
Eryngium sp	NNP
Eryngium spp	NNP
Escherichia coli	NNP
Escherichia sp	NNP
Escherichia spp	NNP
Eschrichtius robustus	NNP
Eschrichtius sp	NNP
Eschrichtius spp	NNP
Esox lucius	NNP
Esox sp	NNP
Esox spp	NNP
Estrilda astrild	NNP
Estrilda caerulescens	NNP
Estrilda melpoda	NNP
Estrilda rhodopyga	NNP
Estrilda sp	NNP
Estrilda spp	NNP
Estrilda troglodytes	NNP
Eubalaena australis	NNP
Eubalaena glacialis	NNP
Eubalaena japonica	NNP
Eubalaena sp	NNP
Eubalaena spp	NNP
Eucalyptus globulus	NNP
Eucalyptus sp	NNP
Eucalyptus spp	NNP
Euplectes afer	NNP
Euplectes ardens	NNP
Euplectes franciscanus	NNP
Euplectes hordeaceus	NNP
Euplectes macrourus	NNP
Euplectes orix	NNP
Euplectes progne	NNP
Euplectes sp	NNP
Euplectes spp	NNP
European hedgehog	NNP
European sp	NNP
European spp	NNP
Felis catus	NNP
Felis silvestris	NNP
Felis sp	NNP
Felis spp	NNP
Feresa attenuata	NNP
Feresa sp	NNP
Feresa spp	NNP
Ficedula albicollis	NNP
Ficedula sp	NNP
Ficedula spp	NNP
Fissipeds –	NNP
Fissipeds sp	NNP
Fissipeds spp	NNP
Fonticula alba	NNP
Fonticula sp	NNP
Fonticula spp	NNP
Francisella sp	NNP
Francisella spp	NNP
Francisella tularensis	NNP
Francolinus francolinus	NNP
Francolinus sp	NNP
Francolinus spp	NNP
Fringilla coelebs	NNP
Fringilla sp	NNP
Fringilla spp	NNP
Fundulus heteroclitus	NNP
Fundulus sp	NNP
Fundulus spp	NNP
Fusobacterium nucleatum	NNP
Fusobacterium sp	NNP
Fusobacterium spp	NNP
Gadus morhua	NNP
Gadus sp	NNP
Gadus spp	NNP
Galdieria sp	NNP
Galdieria spp	NNP
Galdieria sulphuraria	NNP
Galemys pyrenaicus	NNP
Galemys sp	NNP
Galemys spp	NNP
Galinsoga parviflora	NNP
Galinsoga sp	NNP
Galinsoga spp	NNP
Gallus gallus	NNP
Gallus sp	NNP
Gallus spp	NNP
Gambusia holbrooki	NNP
Gambusia sp	NNP
Gambusia spp	NNP
Gardnerella sp	NNP
Gardnerella spp	NNP
Gardnerella vaginalis	NNP
Garrulax leucolophus	NNP
Garrulax sp	NNP
Garrulax spp	NNP
Gasterosteus aculeatus	NNP
Gasterosteus sp	NNP
Gasterosteus spp	NNP
Gaultheria procumbens	NNP
Gelsemium sempervirens	NNP
Genetta genetta	NNP
Genetta sp	NNP
Genetta spp	NNP
Giardia intestinalis	NNP
Giardia lamblia	NNP
Giardia sp	NNP
Giardia spp	NNP
Ginkgo biloba	NNP
Ginkgo sp	NNP
Ginkgo spp	NNP
Globicephala macrorhynchus	NNP
Globicephala melas	NNP
Globicephala sp	NNP
Globicephala spp	NNP
Glycine max	NNP
Glycine sp	NNP
Glycine spp	NNP
Gorilla gorilla	NNP
Gorilla sp	NNP
Gorilla spp	NNP
Grampus griseus	NNP
Grampus sp	NNP
Grampus spp	NNP
Gratiola officinalis	NNP
Gregarina niphandrodes	NNP
Gregarina sp	NNP
Gregarina spp	NNP
Grus grus	NNP
Grus sp	NNP
Grus spp	NNP
Guillardia sp	NNP
Guillardia spp	NNP
Guillardia theta	NNP
Haemophilus ducreyi	NNP
Haemophilus influenzae	NNP
Haemophilus parainfluenzae	NNP
Haemophilus pertussis	NNP
Haemophilus sp	NNP
Haemophilus spp	NNP
Haemophilus vaginalis	NNP
Hakea salicifolia	NNP
Hakea sericea	NNP
Hakea sp	NNP
Hakea spp	NNP
Hammondia hammondi	NNP
Hammondia sp	NNP
Hammondia spp	NNP
Hedychium gardnerianum	NNP
Hedychium sp	NNP
Hedychium spp	NNP
Helicobacter pylori	NNP
Helicobacter sp	NNP
Helicobacter spp	NNP
Heliconius melpomene	NNP
Heliconius sp	NNP
Heliconius spp	NNP
Helleborus viridis	NNP
Helobdella robusta	NNP
Helobdella sp	NNP
Helobdella spp	NNP
Herpestes ichneumon	NNP
Herpestes sp	NNP
Herpestes spp	NNP
Heterocephalus glaber	NNP
Heterocephalus sp	NNP
Heterocephalus spp	NNP
Hirundo rustica	NNP
Hirundo sp	NNP
Hirundo spp	NNP
Homo antecessor	NNP
Homo cepranensis	NNP
Homo erectus	NNP
Homo ergaster	NNP
Homo floresiensis	NNP
Homo gautengensis	NNP
Homo habilis	NNP
Homo heidelbergensis	NNP
Homo naledi	NNP
Homo neanderthalensis	NNP
Homo rhodesiensis	NNP
Homo rudolfensis	NNP
Homo sapiens	NNP
Homo sp	NNP
Homo spp	NNP
Homo tsaichangensis	NNP
Hordeum sp	NNP
Hordeum spp	NNP
Hordeum vulgare	NNP
Hyaloperonospora arabidopsidis	NNP
Hyaloperonospora sp	NNP
Hyaloperonospora spp	NNP
Hyperoodon ampullatus	NNP
Hyperoodon planifrons	NNP
Hyperoodon sp	NNP
Hyperoodon spp	NNP
Ichthyophthirius multifiliis	NNP
Ichthyophthirius sp	NNP
Ichthyophthirius spp	NNP
Ictalurus punctatus	NNP
Ictalurus sp	NNP
Ictalurus spp	NNP
Ictidomys sp	NNP
Ictidomys spp	NNP
Ictidomys tridecemlineatusaimiri	NNP
Ilex aquifolium	NNP
Ilex sp	NNP
Ilex spp	NNP
Inia geoffrensis	NNP
Inia sp	NNP
Inia spp	NNP
Ipomoea acuminata	NNP
Ipomoea sp	NNP
Ipomoea spp	NNP
Ixodes scapularis	NNP
Ixodes sp	NNP
Ixodes spp	NNP
Juniperus oxycedrus	NNP
Klebsiella pneumoniae	NNP
Klebsiella sp	NNP
Klebsiella spp	NNP
Kogia breviceps	NNP
Kogia sima	NNP
Kogia sp	NNP
Kogia spp	NNP
Lactobacillus acidophilus	NNP
Lactobacillus bulgaricus	NNP
Lactobacillus casei	NNP
Lactobacillus sp	NNP
Lactobacillus spp	NNP
Lactococcus lactis	NNP
Lactococcus sp	NNP
Lactococcus spp	NNP
Lagenodelphis hosei	NNP
Lagenodelphis sp	NNP
Lagenodelphis spp	NNP
Lagenorhynchus acutus	NNP
Lagenorhynchus albirostris	NNP
Lagenorhynchus australissodelphis	NNP
Lagenorhynchus cruciger	NNP
Lagenorhynchus obliquidens	NNP
Lagenorhynchus obscurus	NNP
Lagenorhynchus sp	NNP
Lagenorhynchus spp	NNP
Lamprotornis sp	NNP
Lamprotornis spp	NNP
Lantana camara	NNP
Lantana sp	NNP
Lantana spp	NNP
Larus michahellis	NNP
Larus sp	NNP
Larus spp	NNP
Latimeria chalumnae	NNP
Latimeria sp	NNP
Latimeria spp	NNP
Leersia perrieri	NNP
Leersia sp	NNP
Leersia spp	NNP
Legionella pneumophila	NNP
Legionella sp	NNP
Legionella spp	NNP
Leiothrix lutea	NNP
Leiothrix sp	NNP
Leiothrix spp	NNP
Leishmania braziliensis	NNP
Leishmania donovani	NNP
Leishmania infantum	NNP
Leishmania major	NNP
Leishmania mexicana	NNP
Leishmania panamensis	NNP
Leishmania sp	NNP
Leishmania spp	NNP
Lepeophtheirus salmonis	NNP
Lepeophtheirus sp	NNP
Lepeophtheirus spp	NNP
Lepisosteus oculatus	NNP
Lepisosteus sp	NNP
Lepisosteus spp	NNP
Lepomis gibbosus	NNP
Lepomis sp	NNP
Lepomis spp	NNP
Leptomonas pyrrhocoris	NNP
Leptomonas seymouri	NNP
Leptomonas sp	NNP
Leptomonas spp	NNP
Leptoptilos crumeniferus	NNP
Leptoptilos sp	NNP
Leptoptilos spp	NNP
Lepus granatensis	NNP
Lepus sp	NNP
Lepus spp	NNP
Lingula anatina	NNP
Lingula sp	NNP
Lingula spp	NNP
Lipotes sp	NNP
Lipotes spp	NNP
Lipotes vexillifer	NNP
Listeria monocytogenes	NNP
Listeria sp	NNP
Listeria spp	NNP
Loa loa	NNP
Loa sp	NNP
Loa spp	NNP
Lonchura cantans	NNP
Lonchura maja	NNP
Lonchura malacca	NNP
Lonchura punctulata	NNP
Lonchura sp	NNP
Lonchura spp	NNP
Lophophorus impejanus	NNP
Lophophorus sp	NNP
Lophophorus spp	NNP
Lotharella oceanica	NNP
Lotharella sp	NNP
Lotharella spp	NNP
Lottia gigantea	NNP
Lottia sp	NNP
Lottia spp	NNP
Loxodonta africana	NNP
Loxodonta sp	NNP
Loxodonta spp	NNP
Lucilia cuprina	NNP
Lucilia sp	NNP
Lucilia spp	NNP
Lutra lutra	NNP
Lutra sp	NNP
Lutra spp	NNP
Lynx pardinus	NNP
Lynx sp	NNP
Lynx spp	NNP
Macaca fascicularis	NNP
Macaca mulatta	NNP
Macaca sp	NNP
Macaca spp	NNP
Macropus eugenii	NNP
Macropus sp	NNP
Macropus spp	NNP
Martes foina	NNP
Martes martes	NNP
Martes sp	NNP
Martes spp	NNP
Medicago sp	NNP
Medicago spp	NNP
Medicago truncatula	NNP
Megaptera novaeangliae	NNP
Megaptera sp	NNP
Megaptera spp	NNP
Megaselia scalaris	NNP
Megaselia sp	NNP
Megaselia spp	NNP
Meleagris gallopavo	NNP
Meleagris sp	NNP
Meleagris spp	NNP
Meles meles	NNP
Meles sp	NNP
Meles spp	NNP
Melia azedarach	NNP
Melitaea cinxia	NNP
Melitaea sp	NNP
Melitaea spp	NNP
Melopsittacus sp	NNP
Melopsittacus spp	NNP
Melopsittacus undulatus	NNP
Mesoplodon bidens	NNP
Mesoplodon bowdoini	NNP
Mesoplodon carlhubbsindopacetus	NNP
Mesoplodon densirostris	NNP
Mesoplodon europaeus	NNP
Mesoplodon ginkgodens	NNP
Mesoplodon grayi	NNP
Mesoplodon hectori	NNP
Mesoplodon layardii	NNP
Mesoplodon mirus	NNP
Mesoplodon perrini	NNP
Mesoplodon peruvianus	NNP
Mesoplodon sp	NNP
Mesoplodon spp	NNP
Mesoplodon stejnegeri	NNP
Mesoplodon traversii	NNP
Methanobacterium extroquens	NNP
Methanobacterium sp	NNP
Methanobacterium spp	NNP
Microbacterium multiforme	NNP
Microbacterium sp	NNP
Microbacterium spp	NNP
Microcebus murinus	NNP
Microcebus sp	NNP
Microcebus spp	NNP
Micrococcus luteus	NNP
Micrococcus sp	NNP
Micrococcus spp	NNP
Micropterus salmoides	NNP
Micropterus sp	NNP
Micropterus spp	NNP
Microtus agrestis	NNP
Microtus cabrerae	NNP
Microtus duodecimcostatus	NNP
Microtus lusitanicus	NNP
Microtus ochrogaster	NNP
Microtus sp	NNP
Microtus spp	NNP
Miniopterus schreibersii	NNP
Miniopterus sp	NNP
Miniopterus spp	NNP
Mnemiopsis leidyi	NNP
Mnemiopsis sp	NNP
Mnemiopsis spp	NNP
Monachus monachus	NNP
Monachus sp	NNP
Monachus spp	NNP
Monodelphis domestica	NNP
Monodelphis sp	NNP
Monodelphis spp	NNP
Monodon monoceros	NNP
Monodon sp	NNP
Monodon spp	NNP
Monosiga brevicollis	NNP
Monosiga sp	NNP
Monosiga spp	NNP
Moraxella catarrhalis	NNP
Moraxella sp	NNP
Moraxella spp	NNP
Motacilla cinerea	NNP
Motacilla sp	NNP
Motacilla spp	NNP
Musa acuminata	NNP
Musa sp	NNP
Musa spp	NNP
Mus musculus	NNP
Mus sp	NNP
Mus spp	NNP
Mus spretus	NNP
Mustela erminea	NNP
Mustela nivalis	NNP
Mustela putorius	NNP
Mustela sp	NNP
Mustela spp	NNP
Mycobacterium avium	NNP
Mycobacterium bovis	NNP
Mycobacterium diphtheriae	NNP
Mycobacterium intracellulare	NNP
Mycobacterium lepraemurium	NNP
Mycobacterium leprae	NNP
Mycobacterium phlei	NNP
Mycobacterium smegmatis	NNP
Mycobacterium sp	NNP
Mycobacterium spp	NNP
Mycobacterium tuberculosis	NNP
Mycoplasma fermentans	NNP
Mycoplasma genitalium	NNP
Mycoplasma hominis	NNP
Mycoplasma penetrans	NNP
Mycoplasma pneumoniae	NNP
Mycoplasma sp	NNP
Mycoplasma spp	NNP
Mycteria ibis	NNP
Mycteria sp	NNP
Mycteria spp	NNP
Myiopsitta monachus	NNP
Myiopsitta sp	NNP
Myiopsitta spp	NNP
Myoporum sp	NNP
Myoporum spp	NNP
Myoporum tenuifolium	NNP
Myotis bechsteini	NNP
Myotis daubentonii	NNP
Myotis emarginatus	NNP
Myotis escalerai	NNP
Myotis lucifugus	NNP
Myotis myotis	NNP
Myotis mystacinus	NNP
Myotis nattereri	NNP
Myotis sp	NNP
Myotis spp	NNP
Myriophyllum brasiliensis	NNP
Myriophyllum sp	NNP
Myriophyllum spp	NNP
Myristica fragrans	NNP
Naegleria gruberi	NNP
Naegleria sp	NNP
Naegleria spp	NNP
Nandayus nenday	NNP
Nandayus sp	NNP
Nandayus spp	NNP
Nannochloropsis gaditana	NNP
Nannochloropsis sp	NNP
Nannochloropsis spp	NNP
Nasonia sp	NNP
Nasonia spp	NNP
Nasonia vitripennis	NNP
Neisseria gonorrhoeae	NNP
Neisseria meningitidis	NNP
Neisseria sp	NNP
Neisseria spp	NNP
Nematostella sp	NNP
Nematostella spp	NNP
Nematostella vectensis	NNP
Neomys anomalus	NNP
Neomys sp	NNP
Neomys spp	NNP
Neophocaena phocaenoides	NNP
Neophocaena sp	NNP
Neophocaena spp	NNP
Nerium oleander	NNP
Nicotiana glauca	NNP
Nicotiana sp	NNP
Nicotiana spp	NNP
Nomascus leucogenys	NNP
Nomascus sp	NNP
Nomascus spp	NNP
Nyctalus azoreum	NNP
Nyctalus lasiopterus	NNP
Nyctalus leisleri	NNP
Nyctalus noctula	NNP
Nyctalus sp	NNP
Nyctalus spp	NNP
Nymphicus hollandicus	NNP
Nymphicus sp	NNP
Nymphicus spp	NNP
Ochotona princeps	NNP
Ochotona sp	NNP
Ochotona spp	NNP
Octopus bimaculoides	NNP
Octopus sp	NNP
Octopus spp	NNP
Oena capensis	NNP
Oena sp	NNP
Oena spp	NNP
Onchocerca sp	NNP
Onchocerca spp	NNP
Onchocerca volvulus	NNP
Opuntia ficus	NNP
Opuntia sp	NNP
Opuntia spp	NNP
Orcaella brevirostris	NNP
Orcaella heinsohni	NNP
Orcaella sp	NNP
Orcaella spp	NNP
Orcinus orca	NNP
Orcinus sp	NNP
Orcinus spp	NNP
Oreochromis niloticus	NNP
Oreochromis sp	NNP
Oreochromis spp	NNP
Ornithorhynchus anatinus	NNP
Ornithorhynchus sp	NNP
Ornithorhynchus spp	NNP
Orycteropus afer	NNP
Orycteropus sp	NNP
Orycteropus spp	NNP
Oryctolagus cuniculus	NNP
Oryctolagus sp	NNP
Oryctolagus spp	NNP
Oryza barthii	NNP
Oryza brachyantha	NNP
Oryza glaberrima	NNP
Oryza glumaepatula	NNP
Oryza longistaminata	NNP
Oryza meridionalis	NNP
Oryza nivara	NNP
Oryza punctata	NNP
Oryza rufipogon	NNP
Oryza sativa	NNP
Oryza sp	NNP
Oryza spp	NNP
Oryzias latipes	NNP
Oryzias sp	NNP
Oryzias spp	NNP
Ostreococcus lucimarinus	NNP
Ostreococcus sp	NNP
Ostreococcus spp	NNP
Otolemur garnettii	NNP
Otolemur sp	NNP
Otolemur spp	NNP
Ovis ariesorex	NNP
Ovis sp	NNP
Ovis spp	NNP
Oxalis pes	NNP
Oxalis sp	NNP
Oxalis spp	NNP
Oxytricha sp	NNP
Oxytricha spp	NNP
Oxytricha trifallax	NNP
Oxyura jamaicensis	NNP
Oxyura sp	NNP
Oxyura spp	NNP
Padda oryzivora	NNP
Padda sp	NNP
Padda spp	NNP
Pan sp	NNP
Pan spp	NNP
Pan troglodytes	NNP
Papio anubis	NNP
Papio hamadryas	NNP
Papio sp	NNP
Papio spp	NNP
Paramecium sp	NNP
Paramecium spp	NNP
Paramecium tetraurelia	NNP
Passer domesticus	NNP
Passer hispaniolensis	NNP
Passer sp	NNP
Passer spp	NNP
Pasteurella multocida	NNP
Pasteurella sp	NNP
Pasteurella spp	NNP
Pasteurella tularensis	NNP
Paulinella chromatophora	NNP
Paulinella sp	NNP
Paulinella spp	NNP
Pediculus humanus	NNP
Pediculus sp	NNP
Pediculus spp	NNP
Pelecanus onocrotalus	NNP
Pelecanus sp	NNP
Pelecanus spp	NNP
Pelodiscus sinensis	NNP
Pelodiscus sp	NNP
Pelodiscus spp	NNP
Peponocephala electra	NNP
Peponocephala sp	NNP
Peponocephala spp	NNP
Perkinsela sp	NNP
Perkinsela spp	NNP
Perkinsus marinus	NNP
Perkinsus sp	NNP
Perkinsus spp	NNP
Petromyzon marinus	NNP
Petromyzon sp	NNP
Petromyzon spp	NNP
Phaeodactylum sp	NNP
Phaeodactylum spp	NNP
Phaeodactylum tricornutum	NNP
Phasianus colchicus	NNP
Phasianus sp	NNP
Phasianus spp	NNP
Phoca sp	NNP
Phoca spp	NNP
Phoca vitulina	NNP
Phocoena phocoena	NNP
Phocoena sinus	NNP
Phocoena spinipinnis	NNP
Phocoena sp	NNP
Phocoena spp	NNP
Phocoenoides dalli	NNP
Phocoenoides sp	NNP
Phocoenoides spp	NNP
Physcomitrella patens	NNP
Physcomitrella sp	NNP
Physcomitrella spp	NNP
Physeter macrocephalus	NNP
Physeter sp	NNP
Physeter spp	NNP
Physostigma venenosum	NNP
Physter macrocephalus	NNP
Physter sp	NNP
Physter spp	NNP
Phytomonas sp	NNP
Phytomonas spp	NNP
Phytophthora infestans	NNP
Phytophthora kernoviae	NNP
Phytophthora lateralis	NNP
Phytophthora nicotianae	NNP
Phytophthora parasitica	NNP
Phytophthora ramorum	NNP
Phytophthora sojae	NNP
Phytophthora sp	NNP
Phytophthora spp	NNP
Pinus pinaster	NNP
Pinus sp	NNP
Pinus spp	NNP
Pinus sylvestris	NNP
Pipistrellus maderensis	NNP
Pipistrellus sp	NNP
Pipistrellus spp	NNP
Pittosporum sp	NNP
Pittosporum spp	NNP
Pittosporum undulatum	NNP
Plasmodiophora brassicae	NNP
Plasmodiophora sp	NNP
Plasmodiophora spp	NNP
Plasmodium berghei	NNP
Plasmodium chabaudi	NNP
Plasmodium cynomolgi	NNP
Plasmodium falciparum	NNP
Plasmodium fragile	NNP
Plasmodium gaboni	NNP
Plasmodium inui	NNP
Plasmodium knowlesi	NNP
Plasmodium reichenowi	NNP
Plasmodium sp	NNP
Plasmodium spp	NNP
Plasmodium vinckei	NNP
Plasmodium vivax	NNP
Plasmodium yoelii	NNP
Plasmopara halstedii	NNP
Plasmopara sp	NNP
Plasmopara spp	NNP
Platanista gangetica	NNP
Platanista sp	NNP
Platanista spp	NNP
Plecotus auritus	NNP
Plecotus austriacus	NNP
Plecotus sp	NNP
Plecotus spp	NNP
Plectropterus gambensis	NNP
Plectropterus sp	NNP
Plectropterus spp	NNP
Ploceus cucullatus	NNP
Ploceus melanocephalus	NNP
Ploceus sp	NNP
Ploceus spp	NNP
Ploceus velatus	NNP
Poecilia formosanolis	NNP
Poecilia sp	NNP
Poecilia spp	NNP
Poicephalus senegalus	NNP
Poicephalus sp	NNP
Poicephalus spp	NNP
Polysphondylium pallidum	NNP
Polysphondylium sp	NNP
Polysphondylium spp	NNP
Pongo abelii	NNP
Pongo sp	NNP
Pongo spp	NNP
Pontoporia blainvillei	NNP
Pontoporia sp	NNP
Pontoporia spp	NNP
Populus sp	NNP
Populus spp	NNP
Populus trichocarpa	NNP
Porphyromonas gingivalis	NNP
Porphyromonas sp	NNP
Porphyromonas spp	NNP
Prevotella melaninogenica	NNP
Prevotella sp	NNP
Prevotella spp	NNP
Pristionchus pacificus	NNP
Pristionchus sp	NNP
Pristionchus spp	NNP
Procambarus clarkii	NNP
Procambarus sp	NNP
Procambarus spp	NNP
Procavia capensis	NNP
Procavia sp	NNP
Procavia spp	NNP
Prunus lusitanica	NNP
Prunus persica	NNP
Prunus sp	NNP
Prunus spp	NNP
Psammodromus algirus	NNP
Psammodromus sp	NNP
Psammodromus spp	NNP
Pseudocohnilembus persalinus	NNP
Pseudocohnilembus sp	NNP
Pseudocohnilembus spp	NNP
Pseudomonas aeruginosa	NNP
Pseudomonas sp	NNP
Pseudomonas spp	NNP
Pseudorca crassidens	NNP
Pseudorca sp	NNP
Pseudorca spp	NNP
Psittacula krameri	NNP
Psittacula sp	NNP
Psittacula spp	NNP
Psittacus erithacus	NNP
Psittacus sp	NNP
Psittacus spp	NNP
Pteropus sp	NNP
Pteropus spp	NNP
Pteropus vampyrus	NNP
Pusa hispida	NNP
Pusa sp	NNP
Pusa spp	NNP
Pythium aphanidermatum	NNP
Pythium arrhenomanes	NNP
Pythium irregulare	NNP
Pythium iwayamai	NNP
Pythium sp	NNP
Pythium spp	NNP
Pythium ultimum	NNP
Pythium vexans	NNP
Quelea quelea	NNP
Quelea sp	NNP
Quelea spp	NNP
Quercus coccifera	NNP
Quercus faginea	NNP
Quercus ilex	NNP
Quercus lusitanica	NNP
Quercus pyrenaica	NNP
Quercus robur	NNP
Quercus sp	NNP
Quercus spp	NNP
Quercus suber	NNP
Rattus norvegicus	NNP
Rattus rattus	NNP
Rattus sp	NNP
Rattus spp	NNP
Regulus madeirensis	NNP
Regulus sp	NNP
Regulus spp	NNP
Reticulomyxa filosalpingoeca	NNP
Reticulomyxa sp	NNP
Reticulomyxa spp	NNP
Reynoutria japonica	NNP
Reynoutria sp	NNP
Reynoutria spp	NNP
Rhinolophus euryale	NNP
Rhinolophus ferrumequinum	NNP
Rhinolophus hipposideros	NNP
Rhinolophus mehelyi	NNP
Rhinolophus sp	NNP
Rhinolophus spp	NNP
Rhizobium radiobacter	NNP
Rhizobium sp	NNP
Rhizobium spp	NNP
Rhodnius prolixusarcoptes	NNP
Rhodnius sp	NNP
Rhodnius spp	NNP
Ricinus communis	NNP
Ricinus communis	NNP
Ricinus sp	NNP
Ricinus spp	NNP
Rickettsia prowazekii	NNP
Rickettsia psittaci	NNP
Rickettsia quintana	NNP
Rickettsia rickettsii	NNP
Rickettsia sp	NNP
Rickettsia spp	NNP
Rickettsia trachomae	NNP
Robinia pseudoacacia	NNP
Robinia sp	NNP
Robinia spp	NNP
Rochalimaea henselae	NNP
Rochalimaea quintana	NNP
Rochalimaea sp	NNP
Rochalimaea spp	NNP
Rothia dentocariosa	NNP
Rothia sp	NNP
Rothia spp	NNP
Saccharomyces cerevisiae	NNP
Saccharomyces sp	NNP
Saccharomyces spp	NNP
Salix atrocinerea	NNP
Salix sp	NNP
Salix spp	NNP
Salmonella enteritidis	NNP
Salmonella sp	NNP
Salmonella spp	NNP
Salmonella typhimurium	NNP
Salmonella typhi	NNP
Salmo salar	NNP
Salmo sp	NNP
Salmo spp	NNP
Salvinia molesta	NNP
Salvinia sp	NNP
Salvinia spp	NNP
Saprolegnia diclina	NNP
Saprolegnia parasitica	NNP
Saprolegnia sp	NNP
Saprolegnia spp	NNP
Sarcophilus harrisii	NNP
Sarcophilus sp	NNP
Sarcophilus spp	NNP
Schistosoma mansoni	NNP
Schistosoma sp	NNP
Schistosoma spp	NNP
Sciurus sp	NNP
Sciurus spp	NNP
Sciurus vulgaris	NNP
Selaginella moellendorffii	NNP
Selaginella sp	NNP
Selaginella spp	NNP
Senecio bicolor	NNP
Senecio sp	NNP
Senecio spp	NNP
Serinus canaria	NNP
Serinus serinus	NNP
Serinus sp	NNP
Serinus spp	NNP
Serratia marcescens	NNP
Serratia sp	NNP
Serratia spp	NNP
Sesbania punicea	NNP
Sesbania sp	NNP
Sesbania spp	NNP
Setaria italica	NNP
Setaria sp	NNP
Setaria spp	NNP
Shigella dysenteriae	NNP
Shigella sp	NNP
Shigella spp	NNP
Solanum lycopersicum	NNP
Solanum sp	NNP
Solanum spp	NNP
Solanum tuberosum	NNP
Solenopsis invicta	NNP
Solenopsis sp	NNP
Solenopsis spp	NNP
Sorex granarius	NNP
Sorex minutus	NNP
Sorex sp	NNP
Sorex spp	NNP
Sorghum bicolor	NNP
Sorghum sp	NNP
Sorghum spp	NNP
Sotalia fluviatilis	NNP
Sotalia guianensis	NNP
Sotalia sp	NNP
Sotalia spp	NNP
Sousa chinensis	NNP
Sousa chinensistenella	NNP
Sousa plumbea	NNP
Sousa sp	NNP
Sousa spp	NNP
Sousa teuszi	NNP
Spartina densiflora	NNP
Spartina sp	NNP
Spartina spp	NNP
Sphaeroforma arctica	NNP
Sphaeroforma sp	NNP
Sphaeroforma spp	NNP
Spironucleus salmonicida	NNP
Spironucleus sp	NNP
Spironucleus spp	NNP
Staphylococcus aureus	NNP
Staphylococcus epidermidis	NNP
Staphylococcus sp	NNP
Staphylococcus spp	NNP
Stegodyphus mimosarum	NNP
Stegodyphus sp	NNP
Stegodyphus spp	NNP
Stenella coeruleoalba	NNP
Stenella frontalis	NNP
Stenella sp	NNP
Stenella spp	NNP
Steno bredanensis	NNP
Steno bredanensistenella	NNP
Steno sp	NNP
Steno spp	NNP
Stenotrophomonas maltophilia	NNP
Stenotrophomonas sp	NNP
Stenotrophomonas spp	NNP
Streptococcus agalactiae	NNP
Streptococcus avium	NNP
Streptococcus bovis	NNP
Streptococcus cricetus	NNP
Streptococcus faceium	NNP
Streptococcus faecalis	NNP
Streptococcus ferus	NNP
Streptococcus gallinarum	NNP
Streptococcus lactis	NNP
Streptococcus mitior	NNP
Streptococcus mitis	NNP
Streptococcus mutans	NNP
Streptococcus oralis	NNP
Streptococcus pneumoniae	NNP
Streptococcus pyogenes	NNP
Streptococcus rattus	NNP
Streptococcus salivarius	NNP
Streptococcus sanguis	NNP
Streptococcus sobrinus	NNP
Streptococcus sp	NNP
Streptococcus spp	NNP
Streptopelia roseogrisea	NNP
Streptopelia senegalensis	NNP
Streptopelia sp	NNP
Streptopelia spp	NNP
Strigamia maritima	NNP
Strigamia sp	NNP
Strigamia spp	NNP
Strigomonas culicistylonychia	NNP
Strigomonas sp	NNP
Strigomonas spp	NNP
Strongylocentrotus purpuratustrongyloides	NNP
Strongylocentrotus sp	NNP
Strongylocentrotus spp	NNP
Strychnos ignatii	NNP
Sturnus sp	NNP
Sturnus spp	NNP
Sturnus unicolor	NNP
Sturnus vulgaris	NNP
Suncus etruscus	NNP
Suncus sp	NNP
Suncus spp	NNP
Sus scrofa	NNP
Sus sp	NNP
Sus spp	NNP
Sylvia atricapilla	NNP
Sylvia sp	NNP
Sylvia spp	NNP
Tadarida sp	NNP
Tadarida spp	NNP
Tadarida teniotis	NNP
Taeniopygia guttata	NNP
Taeniopygia sp	NNP
Taeniopygia spp	NNP
Takifugu rubripes	NNP
Takifugu sp	NNP
Takifugu spp	NNP
Talpa occidentalis	NNP
Talpa sp	NNP
Talpa spp	NNP
Tarsius sp	NNP
Tarsius spp	NNP
Tarsius syrichta	NNP
Tasmacetus shepherdi	NNP
Tasmacetus sp	NNP
Tasmacetus spp	NNP
Taxus baccata	NNP
Taxus sp	NNP
Taxus spp	NNP
Tetrahymena sp	NNP
Tetrahymena spp	NNP
Tetrahymena thermophila	NNP
Tetranychus sp	NNP
Tetranychus spp	NNP
Tetranychus urticae	NNP
Tetraodon nigroviridis	NNP
Tetraodon sp	NNP
Tetraodon spp	NNP
Thalassiosira oceanica	NNP
Thalassiosira pseudonana	NNP
Thalassiosira sp	NNP
Thalassiosira spp	NNP
Thecamonas sp	NNP
Thecamonas spp	NNP
Thecamonas trahens	NNP
Theileria annulata	NNP
Theileria equi	NNP
Theileria orientalis	NNP
Theileria parva	NNP
Theileria sp	NNP
Theileria spp	NNP
Thelohanellus kitauei	NNP
Thelohanellus sp	NNP
Thelohanellus spp	NNP
Theobroma cacao	NNP
Theobroma sp	NNP
Theobroma spp	NNP
Threskiornis aethiopicus	NNP
Threskiornis sp	NNP
Threskiornis spp	NNP
Toxoplasma gondii	NNP
Toxoplasma sp	NNP
Toxoplasma spp	NNP
Tradescantia fluminensis	NNP
Tradescantia sp	NNP
Tradescantia spp	NNP
Treponema denticola	NNP
Treponema pallidum	NNP
Treponema sp	NNP
Treponema spp	NNP
Tribolium castaneum	NNP
Tribolium sp	NNP
Tribolium spp	NNP
Trichinella spiralis	NNP
Trichinella sp	NNP
Trichinella spp	NNP
Trichomonas sp	NNP
Trichomonas spp	NNP
Trichomonas vaginalis	NNP
Trichoplax adhaerens	NNP
Trichoplax sp	NNP
Trichoplax spp	NNP
Trifolium pratense	NNP
Trifolium sp	NNP
Trifolium spp	NNP
Triticum aestivum	NNP
Triticum sp	NNP
Triticum spp	NNP
Triticum urartu	NNP
Trypanosoma brucei	NNP
Trypanosoma cruzi	NNP
Trypanosoma rangeli	NNP
Trypanosoma sp	NNP
Trypanosoma spp	NNP
Tupaia belangeri	NNP
Tupaia sp	NNP
Tupaia spp	NNP
Turdus merula	NNP
Turdus sp	NNP
Turdus spp	NNP
Tursiops aduncus	NNP
Tursiops australis	NNP
Tursiops sp	NNP
Tursiops spp	NNP
Tursiops truncatus	NNP
Uraeginthus bengalus	NNP
Uraeginthus sp	NNP
Uraeginthus spp	NNP
Ursus arctos	NNP
Ursus maritimus	NNP
Ursus sp	NNP
Ursus spp	NNP
Vespa sp	NNP
Vespa spp	NNP
Vespa velutina	NNP
Vibrio cholerae	NNP
Vibrio comma	NNP
Vibrio parahaemolyticus	NNP
Vibrio sp	NNP
Vibrio spp	NNP
Vibrio vulnificus	NNP
Vicugna pacos	NNP
Vicugna sp	NNP
Vicugna spp	NNP
Vidua fischeri	NNP
Vidua macroura	NNP
Vidua sp	NNP
Vidua spp	NNP
Vitis sp	NNP
Vitis spp	NNP
Vitis vinifera	NNP
Vitrella brassicaformis	NNP
Vitrella sp	NNP
Vitrella spp	NNP
Vulpes sp	NNP
Vulpes spp	NNP
Vulpes vulpes	NNP
Xenopus laevis	NNP
Xenopus sp	NNP
Xenopus spp	NNP
Xenopus tropicalis	NNP
Xiphophorus maculatus	NNP
Xiphophorus sp	NNP
Xiphophorus spp	NNP
Yersinia enterocolitica	NNP
Yersinia pestis	NNP
Yersinia pseudotuberculosis	NNP
Yersinia sp	NNP
Yersinia spp	NNP
Zalerion maritimum	NNP
Zalerion sp	NNP
Zalerion spp	NNP
Zea mays	NNP
Zea sp	NNP
Zea spp	NNP
Ziphius cavirostris	NNP
Ziphius sp	NNP
Ziphius spp	NNP
Zootermopsis nevadensis	NNP
Zootermopsis sp	NNP
Zootermopsis spp	NNP

