# added postag entries
#-------------------------------------------------------------------------------
# Do not add words here, but report them to languagetool@taaltik.nl
#-------------------------------------------------------------------------------
doffer	doffer	ZNW:EKV:DE_
ebo	ebo	ZNW:EKV
flut	flut	ZNW:EKV:DE_
ozb	ozb	ZNW:EKV:DE_
vof	vof	ZNW:EKV:DE_
waterballon	waterballon	ZNW:EKV:DE_
wink	wink	ZNW:EKV:DE_
dl	dl	MEH
EU	EU	ZNW:EKV:DE_
HTM	HTM	ZNW:EKV:DE_
ex-kok	ex-kok	ZNW:EKV:DE_
ex-flik	ex-flik	ZNW:EKV:DE_
ex-hoer	ex-hoer	ZNW:EKV:DE_
mo-akte	mo-akte	ZNW:EKV:DE_
ex-heks	ex-heks	ZNW:EKV:DE_
botsballon	botsballon	ZNW:EKV:DE_
ex-buur	ex-buur	ZNW:EKV:DE_
e-businessconcept	e-businessconcept	ZNW:EKV:HET
e-inkttechnologie	e-inkttechnologie	ZNW:EKV
i-modegebruiker	i-modegebruiker	ZNW:EKV:DE_
coach-tv	coach-tv	ZNW:EKV:DE_
gsm-contract	gsm-contract	ZNW:EKV:HET
'n	'n	GET:EKV
API	API	ZNW:EKV:DE_
Habsburgs	Habsburgs	BNW:STL:ONV
Skipr-websites	Skipr-websites	ZNW:MRV:DE_
Lagerhuis	Lagerhuis	ZNW:EKV:HET
atb	atb	ZNW:EKV:DE_
eken	eken	WKW:TGW:INF
ghi	ghi	ZNW:EKV:DE_
anti-Spaans	anti-Spaans	BNW:STL:ONV
anti-gsm-stralingsapparaat	anti-gsm-stralingsapparaat	ZNW:EKV:HET
basiskabel-tv	basiskabel-tv	ZNW:EKV:DE_
btw-actie	btw-actie	ZNW:EKV:DE_
e-mailhulp	e-mailhulp	ZNW:EKV:DE_
pc-testen	pc-testen	ZNW:MRV:DE_
e-maildefinities	e-maildefinities	ZNW:MRV:DE_
e-commerceprofessional	e-commerceprofessional	ZNW:EKV:DE_
e-boekenkaart	e-boekenkaart	ZNW:EKV:DE_
btw-tariefwijziging	btw-tariefwijziging	ZNW:EKV:DE_
pc-werk	pc-werk	ZNW:EKV:HET
btw-auto	btw-auto	ZNW:EKV:DE_
pc-bladen	pc-bladen	ZNW:MRV:DE_
flatscreen-lcd-tv	flatscreen-lcd-tv	ZNW:EKV
e-mailtransparantie	e-mailtransparantie	ZNW:EKV:DE_
e-commerceplatformen	e-commerceplatform	ZNW:MRV:DE_
e-mailstoring	e-mailstoring	ZNW:EKV:DE_
btw-dienst	btw-dienst	ZNW:EKV:DE_
btw-kwalificatie	btw-kwalificatie	ZNW:EKV:DE_
e-mailmarketingtool	e-mailmarketingtool	ZNW:EKV:DE_
e-commerceplatforms	e-commerceplatform	ZNW:MRV:DE_
pc-lijn	pc-lijn	ZNW:EKV:DE_
e-commercecomponenten	e-commercecomponent	ZNW:MRV:DE_
e-mailupdate	e-mailupdate	ZNW:EKV:DE_
btw-herzieningsregeling	btw-herzieningsregeling	ZNW:EKV:DE_
e-mailinteracties	e-mailinteracties	ZNW:MRV:DE_
btw-sportvrijstelling	btw-sportvrijstelling	ZNW:EKV:DE_
gsm-data	gsm-data	ZNW:MRV:DE_
e-commercelabel	e-commercelabel	ZNW:EKV
douche-wc-element	douche-wc-element	ZNW:EKV:HET
e-mailvorm	e-mailvorm	ZNW:EKV:DE_
e-learningopleidingen	e-learningopleiding	ZNW:MRV:DE_
btw-kasticket	btw-kasticket	ZNW:EKV:HET
e-commerceland	e-commerceland	ZNW:EKV:HET
e-commercemodel	e-commercemodel	ZNW:EKV:HET
e-mailitems	e-mailitem	ZNW:MRV:DE_
pr-effect	pr-effect	ZNW:EKV:HET
btw-besluit	btw-besluit	ZNW:EKV:HET
btw-activiteiten	btw-activiteit	ZNW:MRV:DE_
btw-afwikkeling	btw-afwikkeling	ZNW:EKV:DE_
e-mailberichtregel	e-mailberichtregel	ZNW:EKV:DE_
e-commercebureau	e-commercebureau	ZNW:EKV:HET
wc-module	wc-module	ZNW:EKV:DE_
e-mailmarketinglijst	e-mailmarketinglijst	ZNW:EKV:DE_
e-mailfouten	e-mailfouten	ZNW:MRV:DE_
btw-overzicht	btw-overzicht	ZNW:EKV:HET
e-mailmenu	e-mailmenu	ZNW:EKV:HET
btw-onderneming	btw-onderneming	ZNW:EKV:DE_
wc-winkel	wc-winkel	ZNW:EKV:DE_
btw-aandeel	btw-aandeel	ZNW:EKV:HET
btw-aangiftetijdvakken	btw-aangiftetijdvakken	ZNW:MRV:DE_
btw-aanpassing	btw-aanpassing	ZNW:EKV:DE_
btw-aanslagen	btw-aanslag	ZNW:MRV:DE_
btw-activering	btw-activering	ZNW:EKV:DE_
btw-actualiteit	btw-actualiteit	ZNW:EKV:DE_
btw-actualiteiten	btw-actualiteit	ZNW:MRV:DE_
btw-adviesgroep	btw-adviesgroep	ZNW:EKV:DE_
btw-afhandeling	btw-afhandeling	ZNW:EKV:DE_
btw-afrekening	btw-afrekening	ZNW:EKV:DE_
btw-aftrekcorrectie	btw-aftrekcorrectie	ZNW:EKV:DE_
btw-ambtenaren	btw-ambtenaar	ZNW:MRV:DE_
btw-audit	btw-audit	ZNW:EKV:DE_
e-commercemodule	e-commercemodule	ZNW:EKV:DE_
btw-belasting	btw-belasting	ZNW:EKV:DE_
btw-belastingkredieten	btw-belastingkredieten	ZNW:MRV:DE_
btw-beleid	btw-beleid	ZNW:EKV:HET
btw-bepalingen	btw-bepaling	ZNW:MRV:DE_
btw-besparing	btw-besparing	ZNW:EKV:DE_
btw-besparingen	btw-besparing	ZNW:MRV:DE_
btw-boeking	btw-boeking	ZNW:EKV:DE_
btw-briefje	btw-briefje	ZNW:EKV:VRK:HET
btw-calculator	btw-calculator	ZNW:EKV:DE_
btw-categorieÃ«n	btw-categorie	ZNW:MRV:DE_
btw-cijfers	btw-cijfers	ZNW:MRV:DE_
btw-circuit	btw-circuit	ZNW:EKV:HET
btw-commissie	btw-commissie	ZNW:EKV:DE_
btw-compensatiegevolgen	btw-compensatiegevolgen	ZNW:MRV:DE_
btw-compensatieregeling	btw-compensatieregeling	ZNW:EKV:DE_
btw-controlekantoren	btw-controlekantoor	ZNW:MRV:DE_
btw-declaraties	btw-declaraties	ZNW:MRV:DE_
btw-derving	btw-derving	ZNW:EKV:DE_
btw-differentiatie	btw-differentiatie	ZNW:EKV:DE_
btw-discussie	btw-discussie	ZNW:EKV:DE_
btw-dossier	btw-dossier	ZNW:EKV:HET
btw-financieringsbron	btw-financieringsbron	ZNW:EKV:DE_
btw-fraudebestrijding	btw-fraudebestrijding	ZNW:EKV:DE_
btw-fraudebestrijdingsstrategie	btw-fraudebestrijdingsstrategie	ZNW:EKV:DE_
btw-fraudezaken	btw-fraudezaak	ZNW:MRV:DE_
btw-garantie	btw-garantie	ZNW:EKV:DE_
btw-gerelateerde	btw-gerelateerde	BNW:STL:VRB
btw-gids	btw-gids	ZNW:EKV:DE_
btw-groep	btw-groep	ZNW:EKV:DE_
btw-handleiding	btw-handleiding	ZNW:EKV:DE_
btw-herzieningstermijnen	btw-herzieningstermijn	ZNW:MRV:DE_
btw-informatie-uitwisselingssysteem	btw-informatie-uitwisselingssysteem	ZNW:EKV:HET
btw-inspecteur	btw-inspecteur	ZNW:EKV:DE_
btw-instrument	btw-instrument	ZNW:EKV:HET
btw-integratieheffing	btw-integratieheffing	ZNW:EKV:DE_
btw-invorderingstermijn	btw-invorderingstermijn	ZNW:EKV:DE_
btw-knelpunten	btw-knelpunten	ZNW:MRV:DE_
btw-kredieten	btw-krediet	ZNW:MRV:DE_
btw-levering	btw-levering	ZNW:EKV:DE_
btw-naheffingsaanslagen	btw-naheffingsaanslag	ZNW:MRV:DE_
btw-nalevingskosten	btw-nalevingskosten	ZNW:MRV:DE_
btw-neutraliteit	btw-neutraliteit	ZNW:EKV:DE_
btw-niveau	btw-niveau	ZNW:EKV:HET
btw-nummercontrole	btw-nummercontrole	ZNW:EKV:DE_
btw-ondernemingsvermogen	btw-ondernemingsvermogen	ZNW:EKV:HET
btw-ondersteuning	btw-ondersteuning	ZNW:EKV:DE_
btw-ongelijkheid	btw-ongelijkheid	ZNW:EKV:DE_
btw-ontvangst	btw-ontvangst	ZNW:EKV:DE_
btw-ontwikkelingen	btw-ontwikkelingen	ZNW:MRV:DE_
btw-opslag	btw-opslag	ZNW:EKV:DE_
btw-overdrachten	btw-overdracht	ZNW:MRV:DE_
btw-overzichten	btw-overzicht	ZNW:MRV:DE_
btw-periodes	btw-periode	ZNW:MRV:DE_
btw-praktijk	btw-praktijk	ZNW:EKV:DE_
btw-presentaties	btw-presentaties	ZNW:MRV:DE_
btw-prestatie	btw-prestatie	ZNW:EKV:DE_
btw-proces	btw-proces	ZNW:EKV:HET
btw-professionals	btw-professionals	ZNW:MRV:DE_
btw-programma	btw-programma	ZNW:EKV:HET
btw-rechten	btw-rechten	ZNW:MRV:DE_
btw-rekening-courant	btw-rekening-courant	ZNW:EKV:DE_
btw-relevante	btw-relevante	BNW:STL:VRB
btw-reparatiewetsvoorstel	btw-reparatiewetsvoorstel	ZNW:EKV:HET
btw-risico's	btw-risico	ZNW:MRV:DE_
btw-rubrieken	btw-rubrieken	ZNW:MRV:DE_
btw-situatie	btw-situatie	ZNW:EKV:DE_
btw-status	btw-status	ZNW:EKV:DE_
btw-strategie	btw-strategie	ZNW:EKV:DE_
btw-structuren	btw-structuur	ZNW:MRV:DE_
btw-structuur	btw-structuur	ZNW:EKV:DE_
btw-studie	btw-studie	ZNW:EKV:DE_
btw-tabel	btw-tabel	ZNW:EKV:DE_
btw-tariefstructuur	btw-tariefstructuur	ZNW:EKV:DE_
btw-tarieftoepassing	btw-tarieftoepassing	ZNW:EKV:DE_
btw-tariefverlaging	btw-tariefverlaging	ZNW:EKV:DE_
btw-tarievenstructuur	btw-tarievenstructuur	ZNW:EKV:DE_
btw-technische	btw-technische	BNW:STL:VRB
btw-tegoed	btw-tegoed	ZNW:EKV:HET
btw-tegoeden	btw-tegoed	ZNW:MRV:DE_
btw-tekort	btw-tekort	ZNW:EKV:HET
btw-termen	btw-termen	ZNW:MRV:DE_
btw-terrein	btw-terrein	ZNW:EKV:HET
btw-transactie	btw-transactie	ZNW:EKV:DE_
btw-transacties	btw-transactie	ZNW:MRV:DE_
btw-uitspraak	btw-uitspraak	ZNW:EKV:DE_
btw-verandering	btw-verandering	ZNW:EKV:DE_
btw-verhaal	btw-verhaal	ZNW:EKV:HET
btw-verklaring	btw-verklaring	ZNW:EKV:DE_
btw-verlegging	btw-verlegging	ZNW:EKV:DE_
btw-verlies	btw-verlies	ZNW:EKV:HET
btw-verliezen	btw-verliezen	ZNW:MRV:DE_
btw-vermelding	btw-vermelding	ZNW:EKV:DE_
btw-verwerking	btw-verwerking	ZNW:EKV:DE_
btw-voldoening	btw-voldoening	ZNW:EKV:DE_
btw-voorschriften	btw-voorschriften	ZNW:MRV:DE_
btw-voorstel	btw-voorstel	ZNW:EKV:HET
btw-voorstellen	btw-voorstellen	ZNW:MRV:DE_
btw-vraag	btw-vraag	ZNW:EKV:DE_
btw-vrijstellingsbepalingen	btw-vrijstellingsbepalingen	ZNW:MRV:DE_
btw-vrijstellingsdrempel	btw-vrijstellingsdrempel	ZNW:EKV:DE_
btw-website	btw-website	ZNW:EKV:DE_
btw-wetgever	btw-wetgever	ZNW:EKV:DE_
btw-zaken	btw-zaak	ZNW:MRV:DE_
e-mailscript	e-mailscript	ZNW:EKV:HET
btw-consequenties	btw-consequenties	ZNW:MRV:DE_
btw-aangiftetijdvak	btw-aangiftetijdvak	ZNW:EKV:HET
e-mailrapporten	e-mailrapport	ZNW:MRV:DE_
btw-zaak	btw-zaak	ZNW:EKV:DE_
btw-perspectief	btw-perspectief	ZNW:EKV:HET
btw-herzieningsregels	btw-herzieningsregels	ZNW:MRV:DE_
e-mailtraining	e-mailtraining	ZNW:EKV:DE_
wc-elementen	wc-elementen	ZNW:MRV:DE_
btw-grens	btw-grens	ZNW:EKV:DE_
pc-test	pc-test	ZNW:EKV:DE_
e-mailvolumes	e-mailvolume	ZNW:MRV:DE_
e-commercemanagers	e-commercemanager	ZNW:MRV:DE_
pc-begeleiding	pc-begeleiding	ZNW:EKV:DE_
e-mailcoach	e-mailcoach	ZNW:EKV:DE_
btw-rapport	btw-rapport	ZNW:EKV:HET
gsm-regels	gsm-regels	ZNW:MRV:DE_
gsm-reus	gsm-reus	ZNW:EKV:DE_
e-boekenaanbod	e-boekenaanbod	ZNW:EKV:HET
e-commerceplannen	e-commerceplannen	ZNW:MRV:DE_
e-commerceplan	e-commerceplan	ZNW:EKV:HET
btw-implicaties	btw-implicaties	ZNW:MRV:DE_
pr-mogelijkheden	pr-mogelijkheden	ZNW:MRV:DE_
e-commercetool	e-commercetool	ZNW:EKV:DE_
e-commercedirecteur	e-commercedirecteur	ZNW:EKV:DE_
btw-boetes	btw-boetes	ZNW:MRV:DE_
pr-filmpje	pr-filmpje	ZNW:EKV:VRK:HET
pc-land	pc-land	ZNW:EKV:HET
btw-drempel	btw-drempel	ZNW:EKV:DE_
wc-technologie	wc-technologie	ZNW:EKV
btw-verordening	btw-verordening	ZNW:EKV:DE_
pc-muziek	pc-muziek	ZNW:EKV:DE_
pc-softwarepiraterij	pc-softwarepiraterij	ZNW:EKV:DE_
gsm-penetratiegraad	gsm-penetratiegraad	ZNW:EKV:DE_
e-learningsprogramma	e-learningsprogramma	ZNW:EKV:HET
gsm-schermen	gsm-schermen	ZNW:MRV:DE_
btw-aftrekpositie	btw-aftrekpositie	ZNW:EKV:DE_
pc-plan	pc-plan	ZNW:EKV:HET
e-mailberichtregels	e-mailberichtregel	ZNW:MRV:DE_
wc-actie	wc-actie	ZNW:EKV:DE_
btw-landbouwvrijstelling	btw-landbouwvrijstelling	ZNW:EKV:DE_
e-mailserie	e-mailserie	ZNW:EKV:DE_
wc-gedrag	wc-gedrag	ZNW:EKV:HET
woonhulp	woonhulp	ZNW:EKV:DE_
btw-boetesysteem	btw-boetesysteem	ZNW:EKV:HET
e-mailretouren	e-mailretouren	ZNW:MRV:DE_
e-mailboek	e-mailboek	ZNW:EKV:HET
wc-kamer	wc-kamer	ZNW:EKV:DE_
btw-administraties	btw-administratie	ZNW:MRV:DE_
e-mailpraktijk	e-mailpraktijk	ZNW:EKV:DE_
e-commerce-ondernemingen	e-commerce-onderneming	ZNW:MRV:DE_
btw-belastingplicht	btw-belastingplicht	ZNW:EKV:DE_
e-learningplatforms	e-learningplatform	ZNW:MRV:DE_
btw-nalevingsregels	btw-nalevingsregels	ZNW:MRV:DE_
btw-winst	btw-winst	ZNW:EKV:DE_
wc-systeem	wc-systeem	ZNW:EKV:HET
btw-werkzaamheden	btw-werkzaamheden	ZNW:MRV:DE_
btw-onderwijsvrijstelling	btw-onderwijsvrijstelling	ZNW:EKV:DE_
btw-besparingsmodel	btw-besparingsmodel	ZNW:EKV:HET
btw-attest	btw-attest	ZNW:EKV:DE_
btw-saldi	btw-saldo	ZNW:MRV:DE_
pr-platform	pr-platform	ZNW:EKV:HET
wc-modules	wc-modules	ZNW:MRV:DE_
gsm-beleid	gsm-beleid	ZNW:EKV:HET
btw-truc	btw-truc	ZNW:EKV:DE_
e-commerce-operaties	e-commerce-operatie	ZNW:MRV:DE_
pr-lijst	pr-lijst	ZNW:EKV:DE_
e-mailadresvalidatie	e-mailadresvalidatie	ZNW:EKV:DE_
e-mailnieuws	e-mailnieuws	ZNW:EKV:HET
e-commerce-experts	e-commerce-expert	ZNW:MRV:DE_
btw-gedeelte	btw-gedeelte	ZNW:EKV:HET
e-mailaanvraag	e-mailaanvraag	ZNW:EKV:DE_
e-commercepartner	e-commercepartner	ZNW:EKV:DE_
pc-maatje	pc-maatje	ZNW:EKV:VRK:HET
e-overheidssystemen	e-overheidssystemen	ZNW:MRV:DE_
btw-privÃ©gebruik	btw-privÃ©gebruik	ZNW:EKV:HET
e-commerce-toepassingen	e-commerce-toepassing	ZNW:MRV:DE_
btw-herzieningstermijn	btw-herzieningstermijn	ZNW:EKV:DE_
e-mailbelasting	e-mailbelasting	ZNW:EKV:DE_
pc-houder	pc-houder	ZNW:EKV:DE_
gsm-wekker	gsm-wekker	ZNW:EKV:DE_
btw-ervaring	btw-ervaring	ZNW:EKV:DE_
e-commerceconcept	e-commerceconcept	ZNW:EKV:HET
pr-trucje	pr-trucje	ZNW:EKV:VRK:HET
e-mailtest	e-mailtest	ZNW:EKV:DE_
gsm-eigenaars	gsm-eigenaar	ZNW:MRV:DE_
wc-ervaring	wc-ervaring	ZNW:EKV:DE_
pc-blad	pc-blad	ZNW:EKV:HET
e-mailmarketingtraining	e-mailmarketingtraining	ZNW:EKV:DE_
e-commercerevolutie	e-commercerevolutie	ZNW:EKV:DE_
e-commerce-architectuur	e-commerce-architectuur	ZNW:EKV:DE_
e-mailontvangst	e-mailontvangst	ZNW:EKV:DE_
e-mailsymbool	e-mailsymbool	ZNW:EKV:HET
btw-maandaangiften	btw-maandaangiften	ZNW:MRV:DE_
e-mailmarketinguitingen	e-mailmarketinguiting	ZNW:MRV:DE_
btw-handboek	btw-handboek	ZNW:EKV:HET
e-mailkolom	e-mailkolom	ZNW:EKV:DE_
pc-teksten	pc-teksten	ZNW:MRV:DE_
pr-organisatie	pr-organisatie	ZNW:EKV:DE_
gsm-unit	gsm-unit	ZNW:EKV:DE_
pr-perspectief	pr-perspectief	ZNW:EKV:HET
e-mail-abonnementen	e-mail-abonnementen	ZNW:MRV:DE_
wc-producten	wc-producten	ZNW:MRV:DE_
e-mailpromoties	e-mailpromotie	ZNW:MRV:DE_
e-mailhistorie	e-mailhistorie	ZNW:EKV:DE_
btw-rapportages	btw-rapportages	ZNW:MRV:DE_
e-mailsite	e-mailsite	ZNW:EKV:DE_
e-mailvervuiling	e-mailvervuiling	ZNW:EKV:DE_
e-learningproduct	e-learningproduct	ZNW:EKV:HET
e-commercesectoren	e-commercesector	ZNW:MRV:DE_
e-mailwijzigingen	e-mailwijziging	ZNW:MRV:DE_
e-commerce-beleid	e-commerce-beleid	ZNW:EKV:HET
btw-opeisbaarheidsregels	btw-opeisbaarheidsregels	ZNW:MRV:DE_
e-learningaanbod	e-learningaanbod	ZNW:EKV:HET
btw-vordering	btw-vordering	ZNW:EKV:DE_
pc-audiogeluidskaart	pc-audiogeluidskaart	ZNW:EKV:DE_
e-commerce-reus	e-commerce-reus	ZNW:EKV:DE_
e-mailmarketingtrends	e-mailmarketingtrends	ZNW:EKV:DE_
btw-lijn	btw-lijn	ZNW:EKV:DE_
e-boekenkaarten	e-boekenkaarten	ZNW:MRV:DE_
e-commercebestellingen	e-commercebestellingen	ZNW:MRV:DE_
pr-gehalte	pr-gehalte	ZNW:EKV:HET
btw-lijst	btw-lijst	ZNW:EKV:DE_
e-mailzaak	e-mailzaak	ZNW:EKV:DE_
douche-wc's	douche-wc's	ZNW:MRV:DE_
e-mailvalidatie	e-mailvalidatie	ZNW:EKV:DE_
pc-sturing	pc-sturing	ZNW:EKV:DE_
gsm-land	gsm-land	ZNW:EKV:HET
btw-aanvraag	btw-aanvraag	ZNW:EKV:DE_
e-mailliefde	e-mailliefde	ZNW:EKV:DE_
btw-vakken	btw-vakken	ZNW:MRV:DE_
e-mailmethodiek	e-mailmethodiek	ZNW:EKV:DE_
e-mailsamenvattingen	e-mailsamenvattingen	ZNW:MRV:DE_
gsm-codes	gsm-codes	ZNW:MRV:DE_
e-learningsite	e-learningsite	ZNW:EKV:DE_
pr-kracht	pr-kracht	ZNW:EKV:DE_
pc-profiel	pc-profiel	ZNW:EKV:HET
e-mailprocessing	e-mailprocessing	ZNW:EKV:DE_
btw-landschap	btw-landschap	ZNW:EKV
btw-aandachtspunten	btw-aandachtspunten	ZNW:MRV:DE_
btw-advisering	btw-advisering	ZNW:EKV:DE_
btw-unie	btw-unie	ZNW:EKV:DE_
btw-keuze	btw-keuze	ZNW:EKV:DE_
e-boekenmakers	e-boekenmakers	ZNW:MRV:DE_
e-commerce-conglomeraat	e-commerce-conglomeraat	ZNW:EKV:HET
e-commerce-gebied	e-commerce-gebied	ZNW:EKV:HET
e-commerce-industrie	e-commerce-industrie	ZNW:EKV:DE_
e-commerce-module	e-commerce-module	ZNW:EKV:DE_
e-commerce-operatie	e-commerce-operatie	ZNW:EKV:DE_
e-commerce-transacties	e-commerce-transacties	ZNW:MRV:DE_
e-commercebusiness	e-commercebusiness	ZNW:EKV:DE_
e-commercedienstverlener	e-commercedienstverlener	ZNW:EKV:DE_
e-commercedoelstellingen	e-commercedoelstellingen	ZNW:MRV:DE_
e-commerceformule	e-commerceformule	ZNW:EKV:DE_
e-commercegebruikers	e-commercegebruikers	ZNW:MRV:DE_
e-commercehandelaren	e-commercehandelaren	ZNW:MRV:DE_
e-commercekanalen	e-commercekanaal	ZNW:MRV:DE_
e-commerceklant	e-commerceklant	ZNW:EKV:DE_
e-commercemarketeers	e-commercemarketeers	ZNW:MRV:DE_
e-commerceondernemers	e-commerceondernemer	ZNW:MRV:DE_
e-commercepartij	e-commercepartij	ZNW:EKV:DE_
e-commercepartijen	e-commercepartij	ZNW:MRV:DE_
e-commerceprocessen	e-commerceprocessen	ZNW:MRV:DE_
e-commerceteam	e-commerceteam	ZNW:EKV:HET
e-commerceteams	e-commerceteam	ZNW:MRV:DE_
e-commercetoepassing	e-commercetoepassing	ZNW:EKV:DE_
e-commercetrein	e-commercetrein	ZNW:EKV:DE_
e-commerceverkopen	e-commerceverkopen	ZNW:MRV:DE_
e-learning-omgeving	e-learning-omgeving	ZNW:EKV:DE_
e-learning-site	e-learning-site	ZNW:EKV:DE_
e-learning-software	e-learning-software	ZNW:EKV:DE_
e-learning-strategie	e-learning-strategie	ZNW:EKV:DE_
e-learning-systeem	e-learning-systeem	ZNW:EKV:HET
e-learningapplicatie	e-learningapplicatie	ZNW:EKV:DE_
e-learningapplicaties	e-learningapplicatie	ZNW:MRV:DE_
e-learningbedrijf	e-learningbedrijf	ZNW:EKV:HET
e-learningbedrijven	e-learningbedrijven	ZNW:MRV:DE_
e-learningconcept	e-learningconcept	ZNW:EKV:HET
e-learningfaciliteiten	e-learningfaciliteiten	ZNW:MRV:DE_
e-learninglessen	e-learninglessen	ZNW:MRV:DE_
e-learningmarkt	e-learningmarkt	ZNW:EKV:DE_
e-learningmogelijkheden	e-learningmogelijkheden	ZNW:MRV:DE_
e-learningontwikkelaars	e-learningontwikkelaar	ZNW:MRV:DE_
e-learningplatformen	e-learningplatform	ZNW:MRV:DE_
e-learningproducten	e-learningproduct	ZNW:MRV:DE_
e-learningprogramma's	e-learningprogramma	ZNW:MRV:DE_
e-learningsessie	e-learningsessie	ZNW:EKV:DE_
e-learningsmodules	e-learningsmodule	ZNW:MRV:DE_
e-learningsoftware	e-learningsoftware	ZNW:EKV:DE_
e-learningtoepassingen	e-learningtoepassing	ZNW:MRV:DE_
e-learningvariant	e-learningvariant	ZNW:EKV:DE_
e-mail-aanvraag	e-mail-aanvraag	ZNW:EKV:DE_
e-mail-adressenlijst	e-mail-adressenlijst	ZNW:EKV:DE_
e-mail-bombardement	e-mail-bombardement	ZNW:EKV:HET
e-mail-bombardementen	e-mail-bombardement	ZNW:MRV:DE_
pr-schema	pr-schema	ZNW:EKV:HET
e-mail-faciliteiten	e-mail-faciliteiten	ZNW:MRV:DE_
e-mail-groet	e-mail-groet	ZNW:EKV:DE_
e-mail-icoontje	e-mail-icoontje	ZNW:EKV:VRK:HET
e-mail-netwerken	e-mail-netwerken	ZNW:MRV:DE_
e-mail-ondersteuning	e-mail-ondersteuning	ZNW:EKV:DE_
e-mail-onderzoek	e-mail-onderzoek	ZNW:EKV:HET
e-mail-order	e-mail-order	ZNW:EKV:DE_
e-mail-reacties	e-mail-reactie	ZNW:MRV:DE_
e-mail-support	e-mail-support	ZNW:EKV:HET
e-mail-uitwisseling	e-mail-uitwisseling	ZNW:EKV:DE_
e-mail-uitwisselingen	e-mail-uitwisseling	ZNW:MRV:DE_
e-mail-update	e-mail-update	ZNW:EKV:DE_
e-mail-variant	e-mail-variant	ZNW:EKV:DE_
e-mailaankondigingen	e-mailaankondiging	ZNW:MRV:DE_
e-mailaansluiting	e-mailaansluiting	ZNW:EKV:DE_
e-mailaanvragen	e-mailaanvragen	ZNW:MRV:DE_
e-mailaccountinstellingen	e-mailaccountinstellingen	ZNW:MRV:DE_
e-mailachterstand	e-mailachterstand	ZNW:EKV:DE_
e-mailactiviteit	e-mailactiviteit	ZNW:EKV:DE_
e-mailadresbestand	e-mailadresbestand	ZNW:EKV:HET
e-mailadresveld	e-mailadresveld	ZNW:EKV:HET
e-mailadreswijzigingen	e-mailadreswijziging	ZNW:MRV:DE_
e-mailadvertenties	e-mailadvertentie	ZNW:MRV:DE_
e-mailadvies	e-mailadvies	ZNW:EKV:HET
e-mailadviezen	e-mailadvies	ZNW:MRV:DE_
e-mailanalyse	e-mailanalyse	ZNW:EKV:DE_
e-mailapparaat	e-mailapparaat	ZNW:EKV:HET
e-mailarchitectuur	e-mailarchitectuur	ZNW:EKV:DE_
e-mailarchiveringssysteem	e-mailarchiveringssysteem	ZNW:EKV:HET
e-mailauthenticatiestandaarden	e-mailauthenticatiestandaarden	ZNW:EKV:DE_
e-mailbedrog	e-mailbedrog	ZNW:EKV:HET
e-mailberichtenverkeer	e-mailberichtenverkeer	ZNW:EKV:HET
e-mailbestelling	e-mailbestelling	ZNW:EKV:DE_
e-mailbestellingen	e-mailbestelling	ZNW:MRV:DE_
e-mailbestemming	e-mailbestemming	ZNW:EKV:DE_
e-mailbeveiliger	e-mailbeveiliger	ZNW:EKV:DE_
e-mailbeveiligingsbedrijf	e-mailbeveiligingsbedrijf	ZNW:EKV:HET
e-mailbeveiligingsoplossing	e-mailbeveiligingsoplossing	ZNW:EKV:DE_
e-mailbevraging	e-mailbevraging	ZNW:EKV:DE_
e-mailbezoekers	e-mailbezoekers	ZNW:MRV:DE_
e-mailbezorgdiensten	e-mailbezorgdiensten	ZNW:MRV:DE_
e-mailbezorging	e-mailbezorging	ZNW:EKV:DE_
e-mailbriefpapier	e-mailbriefpapier	ZNW:EKV:HET
e-mailbrowser	e-mailbrowser	ZNW:EKV:DE_
e-mailbulletins	e-mailbulletin	ZNW:MRV:DE_
e-mailclassificaties	e-mailclassificatie	ZNW:MRV:DE_
e-mailcontactformulier	e-mailcontactformulier	ZNW:EKV:HET
e-mailcontactgegevens	e-mailcontactgegevens	ZNW:MRV:DE_
e-mailconventies	e-mailconventies	ZNW:MRV:DE_
e-mailconversie	e-mailconversie	ZNW:EKV:DE_
e-mailcorrespondenten	e-mailcorrespondenten	ZNW:MRV:DE_
e-mailcyclus	e-mailcyclus	ZNW:EKV:DE_
e-maildatum	e-maildatum	ZNW:EKV:DE_
e-maildiscussies	e-maildiscussie	ZNW:MRV:DE_
e-maildistributie	e-maildistributie	ZNW:EKV:DE_
e-maildreigingen	e-maildreigingen	ZNW:MRV:DE_
e-mailgebied	e-mailgebied	ZNW:EKV:HET
e-mailgedoe	e-mailgedoe	ZNW:EKV:HET
e-mailgedragsrichtlijn	e-mailgedragsrichtlijn	ZNW:EKV:DE_
e-mailhelpdesk	e-mailhelpdesk	ZNW:EKV:DE_
e-mailincident	e-mailincident	ZNW:EKV:HET
e-mailkaartjes	e-mailkaartjes	ZNW:MRV:VRK:DE_
e-mailkalender	e-mailkalender	ZNW:EKV:DE_
e-mailklachten	e-mailklachten	ZNW:MRV:DE_
e-mailkring	e-mailkring	ZNW:EKV:DE_
e-mailleverancier	e-mailleverancier	ZNW:EKV:DE_
e-mailleveranciers	e-mailleverancier	ZNW:MRV:DE_
e-mailloket	e-mailloket	ZNW:EKV:HET
e-mailmachine	e-mailmachine	ZNW:EKV:DE_
e-mailmanager	e-mailmanager	ZNW:EKV:DE_
e-mailmarketingactie	e-mailmarketingactie	ZNW:EKV:DE_
e-mailmarketingacties	e-mailmarketingactie	ZNW:MRV:DE_
e-mailmarketingbedrijf	e-mailmarketingbedrijf	ZNW:EKV:HET
e-mailmarketingberichten	e-mailmarketingberichten	ZNW:MRV:DE_
e-mailmarketingbranche	e-mailmarketingbranche	ZNW:EKV:DE_
e-mailmarketingconferentie	e-mailmarketingconferentie	ZNW:EKV:DE_
e-mailmarketingconsultant	e-mailmarketingconsultant	ZNW:EKV:DE_
e-mailmarketingkanaal	e-mailmarketingkanaal	ZNW:EKV:HET
e-mailmarketingpakketten	e-mailmarketingpakket	ZNW:MRV:DE_
e-mailmarketingpartner	e-mailmarketingpartner	ZNW:EKV:DE_
e-mailmarketingproces	e-mailmarketingproces	ZNW:EKV:HET
e-mailmarketingprogramma's	e-mailmarketingprogramma's	ZNW:EKV:DE_
e-mailmarketingspecialisten	e-mailmarketingspecialisten	ZNW:EKV:DE_
e-mailmarketingsystemen	e-mailmarketingsystemen	ZNW:MRV:DE_
e-mailmarketingtrend	e-mailmarketingtrend	ZNW:EKV:DE_
e-mailmarketingwereld	e-mailmarketingwereld	ZNW:EKV:DE_
e-mailmethode	e-mailmethode	ZNW:EKV:DE_
e-mailmisbruik	e-mailmisbruik	ZNW:EKV:HET
e-mailonderwerptitels	e-mailonderwerptitels	ZNW:MRV:DE_
e-mailonderzoeken	e-mailonderzoeken	ZNW:MRV:DE_
e-mailoproep	e-mailoproep	ZNW:EKV:DE_
e-mailorder	e-mailorder	ZNW:EKV:DE_
e-mailovertreding	e-mailovertreding	ZNW:EKV:DE_
e-mailpagina's	e-mailpagina	ZNW:MRV:DE_
e-mailpaneel	e-mailpaneel	ZNW:EKV:HET
e-mailpartij	e-mailpartij	ZNW:EKV:DE_
e-mailpatronen	e-mailpatronen	ZNW:MRV:DE_
e-mailperformance	e-mailperformance	ZNW:EKV:DE_
e-mailpetitie	e-mailpetitie	ZNW:EKV:DE_
e-mailproces	e-mailproces	ZNW:EKV:HET
e-mailprocessen	e-mailprocessen	ZNW:MRV:DE_
e-mailproducten	e-mailproduct	ZNW:MRV:DE_
e-mailprotest	e-mailprotest	ZNW:EKV:DE_
e-mailpublicatie	e-mailpublicatie	ZNW:EKV:DE_
e-mailquotum	e-mailquotum	ZNW:EKV:HET
e-mailrapportages	e-mailrapportage	ZNW:MRV:DE_
e-mailreactie	e-mailreactie	ZNW:EKV:DE_
e-mailreactiesnelheid	e-mailreactiesnelheid	ZNW:EKV:DE_
e-mailrelatie	e-mailrelatie	ZNW:EKV:DE_
e-mailrelaties	e-mailrelatie	ZNW:MRV:DE_
e-mailreputatietechnologieÃ«n	e-mailreputatietechnologieÃ«n	ZNW:MRV:DE_
e-mailscanners	e-mailscanner	ZNW:MRV:DE_
e-mailschermpje	e-mailschermpje	ZNW:EKV:VRK:HET
e-mailsegment	e-mailsegment	ZNW:EKV:HET
e-mailserviceproviders	e-mailserviceprovider	ZNW:MRV:DE_
e-mailsignaleringen	e-mailsignalering	ZNW:MRV:DE_
e-mailspreekuur	e-mailspreekuur	ZNW:EKV:HET
e-mailstoringen	e-mailstoring	ZNW:MRV:DE_
e-mailtechnieken	e-mailtechniek	ZNW:MRV:DE_
e-mailterreur	e-mailterreur	ZNW:EKV:DE_
e-mailtherapie	e-mailtherapie	ZNW:EKV:DE_
e-mailticket	e-mailticket	ZNW:EKV:HET
e-mailtransmissie	e-mailtransmissie	ZNW:EKV:DE_
e-mailvariant	e-mailvariant	ZNW:EKV:DE_
e-mailveiligheid	e-mailveiligheid	ZNW:EKV:DE_
e-mailverband	e-mailverband	ZNW:EKV:HET
e-mailverhaal	e-mailverhaal	ZNW:EKV:HET
e-mailversies	e-mailversie	ZNW:MRV:DE_
e-mailverslag	e-mailverslag	ZNW:EKV:HET
e-mailverslaving	e-mailverslaving	ZNW:EKV:DE_
e-mailvoorbeeld	e-mailvoorbeeld	ZNW:EKV:HET
e-mailvoucher	e-mailvoucher	ZNW:EKV:DE_
e-mailvriend	e-mailvriend	ZNW:EKV:DE_
e-mailzending	e-mailzending	ZNW:EKV:DE_
e-mailzwendel	e-mailzwendel	ZNW:EKV:DE_
e-overheidsdoelstellingen	e-overheidsdoelstellingen	ZNW:MRV:DE_
e-overheidsgebied	e-overheidsgebied	ZNW:EKV:HET
e-overheidsinitiatieven	e-overheidsinitiatieven	ZNW:MRV:DE_
e-overheidsketens	e-overheidsketens	ZNW:MRV:DE_
e-overheidsontwikkelingen	e-overheidsontwikkeling	ZNW:MRV:DE_
e-overheidsoplossingen	e-overheidsoplossingen	ZNW:MRV:DE_
e-overheidsproducten	e-overheidsproducten	ZNW:MRV:DE_
e-overheidsprogramma's	e-overheidsprogramma	ZNW:MRV:DE_
e-overheidsproject	e-overheidsproject	ZNW:EKV:HET
e-overheidssites	e-overheidssites	ZNW:MRV:DE_
e-overheidsstrategieÃ«n	e-overheidsstrategieÃ«n	ZNW:MRV:DE_
e-overheidsthema's	e-overheidsthema's	ZNW:MRV:DE_
e-learningtools	e-learningtool	ZNW:MRV:DE_
btw-punten	btw-punten	ZNW:MRV:DE_
btw-team	btw-team	ZNW:EKV:HET
wc-regels	wc-regels	ZNW:MRV:DE_
e-mailnieuwsbriefonderwerpen	e-mailnieuwsbriefonderwerpen	ZNW:EKV:DE_
btw-uitvoeringsverordening	btw-uitvoeringsverordening	ZNW:EKV:DE_
e-mail-uitnodiging	e-mail-uitnodiging	ZNW:EKV:DE_
e-commercemerken	e-commercemerken	ZNW:MRV:DE_
pr-training	pr-training	ZNW:EKV:DE_
gsm-tariefplannen	gsm-tariefplan	ZNW:MRV:DE_
e-commerce-ontwikkeling	e-commerce-ontwikkeling	ZNW:EKV:DE_
gsm-mobieltjes	gsm-mobieltjes	ZNW:MRV:VRK:DE_
e-mail-afhandeling	e-mail-afhandeling	ZNW:EKV:DE_
pr-kwaliteiten	pr-kwaliteiten	ZNW:MRV:DE_
e-mailroutine	e-mailroutine	ZNW:EKV:DE_
pc-zaak	pc-zaak	ZNW:EKV:DE_
btw-plaatsbepalingsregels	btw-plaatsbepalingsregels	ZNW:MRV:DE_
e-mailbeveiligingsstandaarden	e-mailbeveiligingsstandaarden	ZNW:MRV:DE_
e-commercecentra	e-commercecentrum	ZNW:MRV:DE_
pc-storing	pc-storing	ZNW:EKV:DE_
e-mailgebruikersnaam	e-mailgebruikersnaam	ZNW:EKV:DE_
e-commerce-afdelingen	e-commerce-afdeling	ZNW:MRV:DE_
e-mailtitel	e-mailtitel	ZNW:EKV:DE_
btw-hoofdbestuur	btw-hoofdbestuur	ZNW:EKV:HET
btw-categorie	btw-categorie	ZNW:EKV:DE_
e-mailverzendlijst	e-mailverzendlijst	ZNW:EKV:DE_
internet-kleuren-tv	internet-kleuren-tv	ZNW:EKV:DE_
gsm-chips	gsm-chips	ZNW:MRV:DE_
gsm-functionaliteit	gsm-functionaliteit	ZNW:EKV:DE_
wc-gehalte	wc-gehalte	ZNW:EKV:HET
btw-registratieplicht	btw-registratieplicht	ZNW:EKV:DE_
e-mailinschrijvingen	e-mailinschrijvingen	ZNW:MRV:DE_
e-mailtitels	e-mailtitels	ZNW:MRV:DE_
e-commercemacht	e-commercemacht	ZNW:EKV:DE_
e-mailtransport	e-mailtransport	ZNW:EKV:HET
e-mailpermissies	e-mailpermissies	ZNW:MRV:DE_
btw-artikel	btw-artikel	ZNW:EKV:HET
wc-papieroriÃ«ntatie	wc-papieroriÃ«ntatie	ZNW:EKV:DE_
e-learningexperiment	e-learningexperiment	ZNW:EKV:HET
btw-besparend	btw-besparend	BNW:STL:ONV
gsm-dienstprovider	gsm-dienstprovider	ZNW:EKV:DE_
wc-kastje	wc-kastje	ZNW:EKV:VRK:HET
e-maildialoog	e-maildialoog	ZNW:EKV:DE_
btw-bestand	btw-bestand	ZNW:EKV:HET
pc-processormarkt	pc-processormarkt	ZNW:EKV:DE_
btw-vrijstellingsbepaling	btw-vrijstellingsbepaling	ZNW:EKV:DE_
btw-artikels	btw-artikel	ZNW:MRV:DE_
e-boekentitels	e-boekentitels	ZNW:MRV:DE_
e-commerceactiviteit	e-commerceactiviteit	ZNW:EKV:DE_
e-mailadreslijsten	e-mailadreslijst	ZNW:MRV:DE_
btw-onderzoek	btw-onderzoek	ZNW:EKV:HET
pc-groepen	pc-groepen	ZNW:MRV:DE_
e-commerceontwikkeling	e-commerceontwikkeling	ZNW:EKV:DE_
wc-bedieningsplaten	wc-bedieningsplaten	ZNW:MRV:DE_
btw-nieuws	btw-nieuws	ZNW:EKV:HET
pc-team	pc-team	ZNW:EKV:HET
btw-toepassingsgebied	btw-toepassingsgebied	ZNW:EKV:HET
gsm-aansluiting	gsm-aansluiting	ZNW:EKV:DE_
e-commercegevoelige	e-commercegevoelige	BNW:STL:VRB
e-commercemagazijn	e-commercemagazijn	ZNW:EKV:HET
btw-revolutie	btw-revolutie	ZNW:EKV:DE_
e-mailoverlast	e-mailoverlast	ZNW:EKV:DE_
e-mail-beveiligingsstandaarden	e-mail-beveiligingsstandaarden	ZNW:MRV:DE_
gsm-gebruikersprofielen	gsm-gebruikersprofiel	ZNW:MRV:DE_
e-commerce-platformen	e-commerce-platformen	ZNW:MRV:DE_
wc-hoogte	wc-hoogte	ZNW:EKV:DE_
btw-kennis	btw-kennis	ZNW:EKV:DE_
wc-tijd	wc-tijd	ZNW:EKV:DE_
gasten-wc's	gasten-wc's	ZNW:MRV:DE_
e-mailmarketingspecialist	e-mailmarketingspecialist	ZNW:EKV:DE_
pc-besturingssoftware	pc-besturingssoftware	ZNW:EKV:DE_
wc-bedieningsplaat	wc-bedieningsplaat	ZNW:EKV:DE_
e-commerceafdeling	e-commerceafdeling	ZNW:EKV:DE_
e-mailgemak	e-mailgemak	ZNW:EKV:HET
e-mail-computers	e-mail-computers	ZNW:MRV:DE_
btw-platform	btw-platform	ZNW:EKV:HET
e-commerceondernemer	e-commerceondernemer	ZNW:EKV:DE_
e-overheidsportalen	e-overheidsportalen	ZNW:MRV:DE_
e-boekencatalogus	e-boekencatalogus	ZNW:EKV:DE_
btw-voorschot	btw-voorschot	ZNW:EKV:HET
btw-loket	btw-loket	ZNW:EKV:HET
e-learningwebsite	e-learningwebsite	ZNW:EKV:DE_
btw-krediet	btw-krediet	ZNW:EKV:HET
e-mailnieuwsservice	e-mailnieuwsservice	ZNW:EKV:DE_
pr-element	pr-element	ZNW:EKV:HET
e-commercetrend	e-commercetrend	ZNW:EKV:DE_
pc-geluiden	pc-geluiden	ZNW:MRV:DE_
e-mailrichtlijnen	e-mailrichtlijn	ZNW:MRV:DE_
btw-claims	btw-claims	ZNW:MRV:DE_
e-commerce-expert	e-commerce-expert	ZNW:EKV:DE_
btw-fraudezaak	btw-fraudezaak	ZNW:EKV:DE_
btw-recept	btw-recept	ZNW:EKV:HET
btw-inspectie	btw-inspectie	ZNW:EKV:DE_
e-commerce-software	e-commerce-software	ZNW:EKV:DE_
e-commerceconversie	e-commerceconversie	ZNW:EKV:DE_
btw-applicaties	btw-applicaties	ZNW:MRV:DE_
pr-blad	pr-blad	ZNW:EKV:HET
gsm-antennebelasting	gsm-antennebelasting	ZNW:EKV:DE_
e-commerce-effect	e-commerce-effect	ZNW:EKV:HET
pc-muziekkaart	pc-muziekkaart	ZNW:EKV:DE_
e-mail-marketing-systeem	e-mail-marketing-systeem	ZNW:EKV:HET
e-commercerecord	e-commercerecord	ZNW:EKV:HET
e-mailtijd	e-mailtijd	ZNW:EKV:DE_
e-mailstandaarden	e-mailstandaarden	ZNW:MRV:DE_
e-mailvoorkeur	e-mailvoorkeur	ZNW:EKV:DE_
pr-kanalen	pr-kanalen	ZNW:MRV:DE_
pc-vriendelijke	pc-vriendelijke	BNW:STL:VRB
e-mailmarketinguiting	e-mailmarketinguiting	ZNW:EKV:DE_
post-pc-wereld	post-pc-wereld	ZNW:EKV:DE_
e-commerce-ondernemer	e-commerce-ondernemer	ZNW:EKV:DE_
e-mailcontactgroep	e-mailcontactgroep	ZNW:EKV:DE_
btw-locatie	btw-locatie	ZNW:EKV:DE_
e-mailaanbod	e-mailaanbod	ZNW:EKV:HET
btw-premievrijstelling	btw-premievrijstelling	ZNW:EKV:DE_
e-mailmarketingnieuwsbrief	e-mailmarketingnieuwsbrief	ZNW:EKV:DE_
e-commerce-programma	e-commerce-programma	ZNW:EKV:HET
wc-gebeuren	wc-gebeuren	ZNW:EKV:HET
e-commercekoning	e-commercekoning	ZNW:EKV:DE_
e-commercehandboek	e-commercehandboek	ZNW:EKV:HET
e-commerce-klanten	e-commerce-klanten	ZNW:MRV:DE_
e-commerce-diensten	e-commerce-diensten	ZNW:MRV:DE_
e-mailcoachingsprogramma	e-mailcoachingsprogramma	ZNW:EKV:HET
e-mailbakken	e-mailbakken	ZNW:MRV:DE_
e-mailspecialist	e-mailspecialist	ZNW:EKV:DE_
e-mailaanhef	e-mailaanhef	ZNW:EKV:DE_
e-mailadresbestanden	e-mailadresbestand	ZNW:MRV:DE_
pc-standaard	pc-standaard	ZNW:EKV:DE_
e-maildomeinnaam	e-maildomeinnaam	ZNW:EKV:DE_
gsm-aanbod	gsm-aanbod	ZNW:EKV:HET
gsm-activiteiten	gsm-activiteit	ZNW:MRV:DE_
gsm-afstand	gsm-afstand	ZNW:EKV:DE_
gsm-alfabet	gsm-alfabet	ZNW:EKV:HET
gsm-apparatuur	gsm-apparatuur	ZNW:EKV:DE_
gsm-applicaties	gsm-applicatie	ZNW:MRV:DE_
gsm-basisstation	gsm-basisstation	ZNW:EKV:HET
gsm-behuizingen	gsm-behuizing	ZNW:MRV:DE_
gsm-besturingssysteem	gsm-besturingssysteem	ZNW:EKV:HET
gsm-betalers	gsm-betalers	ZNW:MRV:DE_
gsm-boxen	gsm-boxen	ZNW:MRV:DE_
gsm-bron	gsm-bron	ZNW:EKV:DE_
gsm-capaciteiten	gsm-capaciteiten	ZNW:MRV:DE_
gsm-compatibiliteit	gsm-compatibiliteit	ZNW:EKV:DE_
gsm-covers	gsm-covers	ZNW:MRV:DE_
gsm-cultuur	gsm-cultuur	ZNW:EKV:DE_
gsm-effecten	gsm-effecten	ZNW:MRV:DE_
gsm-filmpje	gsm-filmpje	ZNW:EKV:VRK:HET
gsm-formaat	gsm-formaat	ZNW:EKV:HET
gsm-foto's	gsm-foto	ZNW:MRV:DE_
gsm-frequentie	gsm-frequentie	ZNW:EKV:DE_
gsm-functie	gsm-functie	ZNW:EKV:DE_
gsm-geheugen	gsm-geheugen	ZNW:EKV:HET
gsm-handleiding	gsm-handleiding	ZNW:EKV:DE_
gsm-hangers	gsm-hanger	ZNW:MRV:DE_
gsm-hersteller	gsm-hersteller	ZNW:EKV:DE_
gsm-incident	gsm-incident	ZNW:EKV:HET
gsm-infrastructuur	gsm-infrastructuur	ZNW:EKV:DE_
gsm-installatie	gsm-installatie	ZNW:EKV:DE_
gsm-jongens	gsm-jongens	ZNW:MRV:DE_
gsm-junks	gsm-junks	ZNW:MRV:DE_
gsm-kraakmethode	gsm-kraakmethode	ZNW:EKV:DE_
gsm-kwaliteit	gsm-kwaliteit	ZNW:EKV:DE_
gsm-landschap	gsm-landschap	ZNW:EKV
gsm-locatie	gsm-locatie	ZNW:EKV:DE_
gsm-marktleider	gsm-marktleider	ZNW:EKV:DE_
gsm-model	gsm-model	ZNW:EKV:HET
gsm-monitoring	gsm-monitoring	ZNW:EKV:DE_
gsm-onderzoek	gsm-onderzoek	ZNW:EKV:HET
gsm-ontvangers	gsm-ontvanger	ZNW:MRV:DE_
gsm-productie	gsm-productie	ZNW:EKV:DE_
gsm-project	gsm-project	ZNW:EKV:HET
gsm-radio	gsm-radio	ZNW:EKV:DE_
gsm-sector	gsm-sector	ZNW:EKV:DE_
gsm-shops	gsm-shops	ZNW:MRV:DE_
gsm-specificatie	gsm-specificatie	ZNW:EKV:DE_
gsm-speler	gsm-speler	ZNW:EKV:DE_
gsm-standaarden	gsm-standaarden	ZNW:MRV:DE_
gsm-stations	gsm-station	ZNW:MRV:DE_
gsm-tarief	gsm-tarief	ZNW:EKV:HET
gsm-technieken	gsm-techniek	ZNW:MRV:DE_
gsm-telefooncentrale	gsm-telefooncentrale	ZNW:EKV:DE_
gsm-telefoonnummer	gsm-telefoonnummer	ZNW:EKV:HET
gsm-telefoonnummers	gsm-telefoonnummers	ZNW:MRV:DE_
gsm-toepassing	gsm-toepassing	ZNW:EKV:DE_
gsm-toepassingen	gsm-toepassing	ZNW:MRV:DE_
gsm-torens	gsm-torens	ZNW:MRV:DE_
gsm-types	gsm-types	ZNW:MRV:DE_
gsm-variant	gsm-variant	ZNW:EKV:DE_
gsm-veld	gsm-veld	ZNW:EKV:HET
gsm-vergunningen	gsm-vergunningen	ZNW:MRV:DE_
gsm-verkopers	gsm-verkopers	ZNW:MRV:DE_
gsm-verzekeringen	gsm-verzekering	ZNW:MRV:DE_
gsm-voorziening	gsm-voorziening	ZNW:EKV:DE_
wc-groep	wc-groep	ZNW:EKV:DE_
pr-straatje	pr-straatje	ZNW:EKV:VRK:HET
e-learning-makers	e-learning-makers	ZNW:MRV:DE_
e-commerceonderneming	e-commerceonderneming	ZNW:EKV:DE_
e-mailopvolging	e-mailopvolging	ZNW:EKV:DE_
e-commerceproces	e-commerceproces	ZNW:EKV:HET
pc-station	pc-station	ZNW:EKV:HET
wc-tekst	wc-tekst	ZNW:EKV:DE_
wc-systemen	wc-systemen	ZNW:MRV:DE_
wc-matje	wc-matje	ZNW:EKV:VRK:HET
e-commercecontract	e-commercecontract	ZNW:EKV:HET
btw-aanslagvoet	btw-aanslagvoet	ZNW:EKV:DE_
e-mail-updates	e-mail-updates	ZNW:MRV:DE_
pr-beeld	pr-beeld	ZNW:EKV:HET
pr-zuster	pr-zuster	ZNW:EKV:DE_
gsm-handel	gsm-handel	ZNW:EKV:HET
btw-ruimte	btw-ruimte	ZNW:EKV:DE_
gsm-behuizing	gsm-behuizing	ZNW:EKV:DE_
hennep-wc-papier	hennep-wc-papier	ZNW:EKV:HET
pr-boekje	pr-boekje	ZNW:EKV:VRK:HET
e-boekenproject	e-boekenproject	ZNW:EKV:HET
e-mailmanagementsoftware	e-mailmanagementsoftware	ZNW:EKV:DE_
e-mailinterviews	e-mailinterview	ZNW:MRV:DE_
e-mailpartijen	e-mailpartij	ZNW:MRV:DE_
wc-leidingen	wc-leidingen	ZNW:MRV:DE_
gsm-leveranciers	gsm-leveranciers	ZNW:MRV:DE_
e-overheidscomponenten	e-overheidscomponenten	ZNW:MRV:DE_
e-commerce-model	e-commerce-model	ZNW:EKV:HET
e-mailmomenten	e-mailmoment	ZNW:MRV:DE_
btw-maandaangevers	btw-maandaangevers	ZNW:MRV:DE_
e-mailrechten	e-mailrechten	ZNW:MRV:DE_
e-mail-inhoud	e-mail-inhoud	ZNW:EKV:DE_
e-mailtoegangscodes	e-mailtoegangscodes	ZNW:MRV:DE_
btw-bepaling	btw-bepaling	ZNW:EKV:DE_
wc-momenten	wc-momenten	ZNW:MRV:DE_
btw-jaaroverzicht	btw-jaaroverzicht	ZNW:EKV:HET
btw-aangifteperiode	btw-aangifteperiode	ZNW:EKV:DE_
btw-delegatie	btw-delegatie	ZNW:EKV:DE_
gsm-melder	gsm-melder	ZNW:EKV:DE_
wc-sessie	wc-sessie	ZNW:EKV:DE_
e-learning-doelen	e-learning-doelen	ZNW:MRV:DE_
ultrabreedbeeld-tv	ultrabreedbeeld-tv	ZNW:EKV:DE_
e-commerceondernemingen	e-commerceonderneming	ZNW:MRV:DE_
e-mailbrij	e-mailbrij	ZNW:EKV:DE_
e-mail-gebruiker	e-mail-gebruiker	ZNW:EKV:DE_
wc-bordje	wc-bordje	ZNW:EKV:VRK:HET
e-commerce-functionaliteit	e-commerce-functionaliteit	ZNW:EKV:DE_
btw-principes	btw-principes	ZNW:MRV:DE_
btw-aangifteformulier	btw-aangifteformulier	ZNW:EKV:HET
gsm-product	gsm-product	ZNW:EKV:HET
pr-adviesbureaus	pr-adviesbureaus	ZNW:MRV:DE_
btw-standaardtarief	btw-standaardtarief	ZNW:EKV:HET
e-commerce-bestellingen	e-commerce-bestellingen	ZNW:MRV:DE_
e-mailbundel	e-mailbundel	ZNW:EKV:DE_
e-mailmanagementoplossing	e-mailmanagementoplossing	ZNW:EKV:DE_
e-mailnorm	e-mailnorm	ZNW:EKV:DE_
btw-brief	btw-brief	ZNW:EKV:DE_
pr-expert	pr-expert	ZNW:EKV:DE_
btw-aangiftetermijnen	btw-aangiftetermijnen	ZNW:MRV:DE_
e-mailroutering	e-mailroutering	ZNW:EKV:DE_
e-commercetechnologie	e-commercetechnologie	ZNW:EKV
e-mailspreekuren	e-mailspreekuur	ZNW:MRV:DE_
btw-fraudeprobleem	btw-fraudeprobleem	ZNW:EKV:HET
e-mailproductiviteit	e-mailproductiviteit	ZNW:EKV:DE_
pc-verhuurservice	pc-verhuurservice	ZNW:EKV:DE_
e-learningontwikkelaar	e-learningontwikkelaar	ZNW:EKV:DE_
btw-ontheffing	btw-ontheffing	ZNW:EKV:DE_
btw-deskundigengroep	btw-deskundigengroep	ZNW:EKV:DE_
pc-privÃ©contracten	pc-privÃ©contracten	ZNW:MRV:DE_
btw-prestaties	btw-prestaties	ZNW:MRV:DE_
pr-nummertje	pr-nummertje	ZNW:EKV:VRK:HET
pr-trainingen	pr-trainingen	ZNW:MRV:DE_
e-mailreputatiesystemen	e-mailreputatiesystemen	ZNW:MRV:DE_
btw-indicatienummer	btw-indicatienummer	ZNW:EKV:HET
micro-pr-technieken	micro-pr-technieken	ZNW:MRV:DE_
e-mailrichtlijn	e-mailrichtlijn	ZNW:EKV:DE_
pc-mogelijkheden	pc-mogelijkheden	ZNW:MRV:DE_
e-mailverlies	e-mailverlies	ZNW:EKV:HET
e-commercemanifestaties	e-commercemanifestaties	ZNW:MRV:DE_
pr-drift	pr-drift	ZNW:EKV:DE_
e-mailconsultatiedienst	e-mailconsultatiedienst	ZNW:EKV:DE_
gsm-informatie	gsm-informatie	ZNW:EKV:DE_
btw-dagen	btw-dagen	ZNW:MRV:DE_
wc-winkelformule	wc-winkelformule	ZNW:EKV:DE_
btw-cafetariaregeling	btw-cafetariaregeling	ZNW:EKV:DE_
gsm-displaytje	gsm-displaytje	ZNW:EKV:VRK:HET
e-commerceregels	e-commerceregels	ZNW:MRV:DE_
e-commerce-shoppers	e-commerce-shoppers	ZNW:MRV:DE_
btw-cursus	btw-cursus	ZNW:EKV:DE_
e-overheidsmaatregelen	e-overheidsmaatregelen	ZNW:MRV:DE_
e-mailmarketingland	e-mailmarketingland	ZNW:EKV:HET
e-mailmanagementmodule	e-mailmanagementmodule	ZNW:EKV:DE_
e-mail-onderwerp	e-mail-onderwerp	ZNW:EKV:HET
e-mail-marketinguitingen	e-mail-marketinguitingen	ZNW:MRV:DE_
e-overheidsexpert	e-overheidsexpert	ZNW:EKV:DE_
e-maildesignwedstrijd	e-maildesignwedstrijd	ZNW:EKV:DE_
e-commercecontext	e-commercecontext	ZNW:EKV:DE_
hamburger-pr-dame	hamburger-pr-dame	ZNW:EKV
pc-systeemfactoren	pc-systeemfactoren	ZNW:MRV:DE_
pr-redenen	pr-redenen	ZNW:MRV:DE_
e-mailkoppen	e-mailkoppen	ZNW:MRV:DE_
e-learning-deskundigheid	e-learning-deskundigheid	ZNW:EKV:DE_
e-mail-printopdrachten	e-mail-printopdrachten	ZNW:MRV:DE_
e-learning-specialisten	e-learning-specialisten	ZNW:MRV:DE_
wc-verplichting	wc-verplichting	ZNW:EKV:DE_
wc-inbouwelementen	wc-inbouwelementen	ZNW:MRV:DE_
pr-stijl	pr-stijl	ZNW:EKV:DE_
e-commerce-partner	e-commerce-partner	ZNW:EKV:DE_
e-commerce-klant	e-commerce-klant	ZNW:EKV:DE_
e-commercecijfers	e-commercecijfers	ZNW:MRV:DE_
e-mailtelefoon	e-mailtelefoon	ZNW:EKV:DE_
pc-kabeltje	pc-kabeltje	ZNW:EKV:VRK:HET
e-mail-marketingplanning	e-mail-marketingplanning	ZNW:EKV:DE_
e-mail-telefoon-brieven	e-mail-telefoon-brieven	ZNW:MRV:DE_
pr-netwerk	pr-netwerk	ZNW:EKV:HET
e-mail-kwestie	e-mail-kwestie	ZNW:EKV:DE_
poppenwc-potten	poppenwc-potten	ZNW:MRV:DE_
e-mailmelders	e-mailmelders	ZNW:MRV:DE_
pr-bijeenkomsten	pr-bijeenkomsten	ZNW:MRV:DE_
e-commercepersoneel	e-commercepersoneel	ZNW:EKV:HET
e-mail-krant	e-mail-krant	ZNW:EKV:DE_
btw-bijtellingspercentage	btw-bijtellingspercentage	ZNW:EKV:HET
pc-elementen	pc-elementen	ZNW:MRV:DE_
pc-besturingstechniek	pc-besturingstechniek	ZNW:EKV:DE_
e-commerce-applicaties	e-commerce-applicaties	ZNW:MRV:DE_
e-commerce-aanbiedingen	e-commerce-aanbiedingen	ZNW:MRV:DE_
e-commerce-velden	e-commerce-velden	ZNW:MRV:DE_
wc-slotje	wc-slotje	ZNW:EKV:VRK:HET
wc-faciliteiten	wc-faciliteiten	ZNW:MRV:DE_
e-mailgigant	e-mailgigant	ZNW:EKV:DE_
e-commercedienst	e-commercedienst	ZNW:EKV:DE_
e-mail-schrijver	e-mail-schrijver	ZNW:EKV:DE_
wc-jaarkalender	wc-jaarkalender	ZNW:EKV:DE_
e-mailbeveiligingsdivisie	e-mailbeveiligingsdivisie	ZNW:EKV:DE_
e-mail-board	e-mail-board	ZNW:EKV:DE_
e-commerce-regio	e-commerce-regio	ZNW:EKV:DE_
e-commercecontainers	e-commercecontainers	ZNW:MRV:DE_
e-learning-markt	e-learning-markt	ZNW:EKV:DE_
e-mailcenter	e-mailcenter	ZNW:EKV:HET
e-mailverzameling	e-mailverzameling	ZNW:EKV:DE_
btw-fonds	btw-fonds	ZNW:EKV:HET
e-mailmarketingblog	e-mailmarketingblog	ZNW:EKV:DE_
gsm-woordenboek	gsm-woordenboek	ZNW:EKV:HET
e-commercestad	e-commercestad	ZNW:EKV:DE_
btw-douaneregeling	btw-douaneregeling	ZNW:EKV:DE_
e-overheidsfront	e-overheidsfront	ZNW:EKV:HET
heren-wc-ontsmettingsmiddelen	heren-wc-ontsmettingsmiddelen	ZNW:MRV:DE_
btw-compensatiepotentie	btw-compensatiepotentie	ZNW:EKV:DE_
e-learning-projecten	e-learning-projecten	ZNW:MRV:DE_
e-commerce-adepten	e-commerce-adepten	ZNW:MRV:DE_
btw-schuldvorderingen	btw-schuldvorderingen	ZNW:MRV:DE_
e-mailgewoonten	e-mailgewoonte	ZNW:MRV:DE_
e-learning-oplossing	e-learning-oplossing	ZNW:EKV:DE_
wc-vrije	wc-vrije	BNW:STL:VRB
e-mailreclamediensten	e-mailreclamediensten	ZNW:MRV:DE_
btw-redenering	btw-redenering	ZNW:EKV:DE_
gsm-verkooppunten	gsm-verkooppunten	ZNW:MRV:DE_
e-mailvertaling	e-mailvertaling	ZNW:EKV:DE_
e-commercestudie	e-commercestudie	ZNW:EKV:DE_
wc-potten-fotograaf	wc-potten-fotograaf	ZNW:EKV:DE_
e-mailuitdraai	e-mailuitdraai	ZNW:EKV:DE_
e-mailbewaarstrategie	e-mailbewaarstrategie	ZNW:EKV:DE_
e-mailverklaring	e-mailverklaring	ZNW:EKV:DE_
e-mailaspecten	e-mailaspecten	ZNW:MRV:DE_
pr-werkgroep	pr-werkgroep	ZNW:EKV:DE_
e-mailscripts	e-mailscript	ZNW:MRV:DE_
e-learninginhoud	e-learninginhoud	ZNW:EKV:DE_
pr-route	pr-route	ZNW:EKV:DE_
e-commerce-strategieÃ«n	e-commerce-strategieÃ«n	ZNW:MRV:DE_
pc-opslagapparaat	pc-opslagapparaat	ZNW:EKV:HET
e-learninginitiatief	e-learninginitiatief	ZNW:EKV:HET
btw-teruggavedienst	btw-teruggavedienst	ZNW:EKV:DE_
e-mailverzendsysteem	e-mailverzendsysteem	ZNW:EKV:HET
btw-belastingadviseur	btw-belastingadviseur	ZNW:EKV:DE_
e-learning-omgevingen	e-learning-omgevingen	ZNW:MRV:DE_
e-commerce-icoon	e-commerce-icoon	ZNW:EKV:DE_
e-commerce-banen	e-commerce-banen	ZNW:MRV:DE_
e-mailindustrie	e-mailindustrie	ZNW:EKV:DE_
pr-bezoek	pr-bezoek	ZNW:EKV:HET
pc-winkelpersoneel	pc-winkelpersoneel	ZNW:EKV:HET
e-mailautomatisering	e-mailautomatisering	ZNW:EKV:DE_
e-mailreeksen	e-mailreeksen	ZNW:MRV:DE_
e-maildesigner	e-maildesigner	ZNW:EKV:DE_
btw-draaiboek	btw-draaiboek	ZNW:EKV:HET
pr-management	pr-management	ZNW:EKV:HET
pr-leider	pr-leider	ZNW:EKV:DE_
e-commercegroep	e-commercegroep	ZNW:EKV:DE_
e-mailovertredingen	e-mailovertreding	ZNW:MRV:DE_
e-learning-community	e-learning-community	ZNW:EKV:DE_
e-mailmarketingfactoren	e-mailmarketingfactoren	ZNW:MRV:DE_
e-learningland	e-learningland	ZNW:EKV:HET
wc-onderzoek	wc-onderzoek	ZNW:EKV:HET
e-mailcliÃ«ntprogramma	e-mailcliÃ«ntprogramma	ZNW:EKV:HET
marge-btw-regel	marge-btw-regel	ZNW:EKV:DE_
e-boekenafzet	e-boekenafzet	ZNW:EKV:DE_
pc-strategie	pc-strategie	ZNW:EKV:DE_
e-mail-adresboeken	e-mail-adresboeken	ZNW:MRV:DE_
wc-tegeltjesbrood	wc-tegeltjesbrood	ZNW:EKV:HET
e-mail-marketingsysteem	e-mail-marketingsysteem	ZNW:EKV:HET
e-mailvervangers	e-mailvervanger	ZNW:MRV:DE_
wc-serie	wc-serie	ZNW:EKV:DE_
pc-beleid	pc-beleid	ZNW:EKV:HET
wc-papierfabrikanten	wc-papierfabrikant	ZNW:MRV:DE_
e-mailmarketingdienstverlener	e-mailmarketingdienstverlener	ZNW:EKV:DE_
pc-spraakherkenningsprogramma	pc-spraakherkenningsprogramma	ZNW:EKV:HET
pc-speciaalzaak	pc-speciaalzaak	ZNW:EKV:DE_
btw-debat	btw-debat	ZNW:EKV:HET
e-boekenassortiment	e-boekenassortiment	ZNW:EKV:HET
e-learningbureau	e-learningbureau	ZNW:EKV:HET
pc-marktpositie	pc-marktpositie	ZNW:EKV:DE_
e-mailserververbindingen	e-mailserververbindingen	ZNW:MRV:DE_
e-mailinzichten	e-mailinzichten	ZNW:MRV:DE_
wc-houder	wc-houder	ZNW:EKV:DE_
wc-oplossingen	wc-oplossingen	ZNW:MRV:DE_
pr-niveau	pr-niveau	ZNW:EKV:HET
e-learningsvormen	e-learningsvormen	ZNW:MRV:DE_
gsm-antenne-netwerk	gsm-antenne-netwerk	ZNW:EKV:HET
wc-beurtje	wc-beurtje	ZNW:EKV:VRK:HET
btw-toestanden	btw-toestanden	ZNW:MRV:DE_
e-mailvriendje	e-mailvriend	ZNW:EKV:VRK:HET
btw-compensatieregel	btw-compensatieregel	ZNW:EKV:DE_
pr-sites	pr-sites	ZNW:MRV:DE_
btw-aftrekgerechtigde	btw-aftrekgerechtigde	BNW:STL:VRB
gsm-opties	gsm-opties	ZNW:MRV:DE_
e-mailverzamelprogramma	e-mailverzamelprogramma	ZNW:EKV:HET
e-commerce-merken	e-commerce-merken	ZNW:MRV:DE_
pc-ziekenhuis	pc-ziekenhuis	ZNW:EKV:HET
btw-toeslag	btw-toeslag	ZNW:EKV:DE_
e-mail-vragen	e-mail-vragen	ZNW:MRV:DE_
btw-herzieningsperiode	btw-herzieningsperiode	ZNW:EKV:DE_
e-mailliefhebbers	e-mailliefhebbers	ZNW:MRV:DE_
pc-internetvergoeding	pc-internetvergoeding	ZNW:EKV:DE_
e-commerce-concept	e-commerce-concept	ZNW:EKV:HET
pc-besturings-systeem	pc-besturings-systeem	ZNW:EKV:HET
e-mailnieuwsbrievenuitgeverij	e-mailnieuwsbrievenuitgeverij	ZNW:EKV:DE_
btw-schalen	btw-schalen	ZNW:MRV:DE_
e-learningproducties	e-learningproductie	ZNW:MRV:DE_
e-learningoplossing	e-learningoplossing	ZNW:EKV:DE_
wc-mogelijkheid	wc-mogelijkheid	ZNW:EKV:DE_
pr-nieuwssites	pr-nieuwssites	ZNW:MRV:DE_
wc-gedragsexpert	wc-gedragsexpert	ZNW:EKV:DE_
e-mailaanmeldingsformulieren	e-mailaanmeldingsformulieren	ZNW:MRV:DE_
pc-onderdeeltje	pc-onderdeeltje	ZNW:EKV:VRK:HET
e-commerceopties	e-commerceopties	ZNW:MRV:DE_
wc-zaken	wc-zaken	ZNW:MRV:DE_
btw-betalingsverplichtingen	btw-betalingsverplichtingen	ZNW:MRV:DE_
e-commerceproef	e-commerceproef	ZNW:EKV:DE_
gsm-datanetwerk	gsm-datanetwerk	ZNW:EKV:HET
btw-boekingsgroepen	btw-boekingsgroepen	ZNW:MRV:DE_
e-mail-adressenbestanden	e-mail-adressenbestanden	ZNW:MRV:DE_
e-commercemagazijnen	e-commercemagazijn	ZNW:MRV:DE_
e-commerce-identiteit	e-commerce-identiteit	ZNW:EKV:DE_
e-mailsoftware-ontwikkelaar	e-mailsoftware-ontwikkelaar	ZNW:EKV:DE_
pr-verbeteringen	pr-verbeteringen	ZNW:MRV:DE_
e-maildrift	e-maildrift	ZNW:EKV:DE_
e-commerceoverzicht	e-commerceoverzicht	ZNW:EKV:HET
e-commerce-professionals	e-commerce-professionals	ZNW:MRV:DE_
wc-rondes	wc-rondes	ZNW:MRV:DE_
btw-gebieden	btw-gebieden	ZNW:MRV:DE_
e-commerceaanpak	e-commerceaanpak	ZNW:EKV:DE_
e-commerce-vallei	e-commerce-vallei	ZNW:EKV:DE_
e-learning-concept	e-learning-concept	ZNW:EKV:HET
e-mailvrouw	e-mailvrouw	ZNW:EKV:DE_
pc-belasting	pc-belasting	ZNW:EKV:DE_
pc-datum	pc-datum	ZNW:EKV:DE_
e-commerce-land	e-commerce-land	ZNW:EKV:HET
e-mailmeldingsvoorkeuren	e-mailmeldingsvoorkeuren	ZNW:MRV:DE_
e-mailclusters	e-mailclusters	ZNW:MRV:DE_
wc-uitvoering	wc-uitvoering	ZNW:EKV:DE_
e-mailstatus	e-mailstatus	ZNW:EKV:DE_
btw-rapportering	btw-rapportering	ZNW:EKV:DE_
pc-toetsmomenten	pc-toetsmomenten	ZNW:MRV:DE_
wc-rollenpiramide	wc-rollenpiramide	ZNW:EKV:DE_
btw-schadeberekeningen	btw-schadeberekeningen	ZNW:MRV:DE_
btw-partner	btw-partner	ZNW:EKV:DE_
e-mailretentiebeleid	e-mailretentiebeleid	ZNW:EKV:HET
e-mailcampagnetool	e-mailcampagnetool	ZNW:EKV:DE_
e-mailmarketing-platformen	e-mailmarketing-platformen	ZNW:MRV:DE_
e-learningcultuur	e-learningcultuur	ZNW:EKV:DE_
wc-papierfabrikant	wc-papierfabrikant	ZNW:EKV:DE_
e-mailhouders	e-mailhouders	ZNW:MRV:DE_
e-mailcontroverse	e-mailcontroverse	ZNW:EKV:DE_
e-mailbeschermingstechnologieÃ«n	e-mailbeschermingstechnologieÃ«n	ZNW:MRV:DE_
btw-risicoanalyse	btw-risicoanalyse	ZNW:EKV:DE_
e-learningportal	e-learningportal	ZNW:EKV:DE_
universiteits-pc-netwerk	universiteits-pc-netwerk	ZNW:EKV:HET
wc-rollenfabriek	wc-rollenfabriek	ZNW:EKV:DE_
e-mail-discussiegroepen	e-mail-discussiegroepen	ZNW:MRV:DE_
e-mail-adres-diefstal	e-mail-adres-diefstal	ZNW:EKV:DE_
e-mailverbeterplan	e-mailverbeterplan	ZNW:EKV:HET
e-mailbehoeften	e-mailbehoeften	ZNW:MRV:DE_
e-overheidsgroep	e-overheidsgroep	ZNW:EKV:DE_
e-mailbundels	e-mailbundels	ZNW:MRV:DE_
e-learningfilmpje	e-learningfilmpje	ZNW:EKV:VRK:HET
pr-kennis	pr-kennis	ZNW:EKV:DE_
pc-herstelfirma	pc-herstelfirma	ZNW:EKV:DE_
pc-insteekkaart	pc-insteekkaart	ZNW:EKV:DE_
btw-factureringsplicht	btw-factureringsplicht	ZNW:EKV:DE_
pr-artikelen	pr-artikelen	ZNW:MRV:DE_
wc-rollenleverancier	wc-rollenleverancier	ZNW:EKV:DE_
e-commerce-systemen	e-commerce-systemen	ZNW:MRV:DE_
e-commercekennis	e-commercekennis	ZNW:EKV:DE_
e-boekenbusiness	e-boekenbusiness	ZNW:EKV:DE_
e-mail-verificatie	e-mail-verificatie	ZNW:EKV:DE_
wc-moment	wc-moment	ZNW:EKV:HET
e-mailmigratiedienst	e-mailmigratiedienst	ZNW:EKV:DE_
e-mail-gebaseerde	e-mail-gebaseerde	BNW:STL:VRB
e-mail-inbreuken	e-mail-inbreuken	ZNW:MRV:DE_
e-commerce-klasje	e-commerce-klasje	ZNW:EKV:VRK:HET
pc-nieuws	pc-nieuws	ZNW:EKV:HET
e-commerceverhaal	e-commerceverhaal	ZNW:EKV:HET
e-mailsoftwarepakket	e-mailsoftwarepakket	ZNW:EKV:HET
e-mailvrienden	e-mailvriend	ZNW:MRV:DE_
pc-tv-diensten	pc-tv-diensten	ZNW:MRV:DE_
btw-invoering	btw-invoering	ZNW:EKV:DE_
e-mailblogs	e-mailblogs	ZNW:MRV:DE_
e-mail-inschrijving	e-mail-inschrijving	ZNW:EKV:DE_
wc-model	wc-model	ZNW:EKV:HET
pc-vrij	pc-vrij	BNW:STL:ONV
e-learningapparatuur	e-learningapparatuur	ZNW:EKV:DE_
e-mailreputatiegegevens	e-mailreputatiegegevens	ZNW:MRV:DE_
wc-papierstaking	wc-papierstaking	ZNW:EKV:DE_
e-mail-gebaseerd	e-mail-gebaseerd	BNW:STL:ONV
e-mailpoort	e-mailpoort	ZNW:EKV:DE_
gsm-gebruikersprofiel	gsm-gebruikersprofiel	ZNW:EKV:HET
e-commerce-inkomsten	e-commerce-inkomsten	ZNW:MRV:DE_
pc-documenten	pc-documenten	ZNW:MRV:DE_
gsm-icoontje	gsm-icoon	ZNW:EKV:VRK:HET
e-mailkader	e-mailkader	ZNW:EKV:HET
e-boekenbestand	e-boekenbestand	ZNW:EKV:HET
pc-processorproducent	pc-processorproducent	ZNW:EKV:DE_
btw-werkingssfeer	btw-werkingssfeer	ZNW:EKV:DE_
e-overheidsprincipes	e-overheidsprincipes	ZNW:MRV:DE_
e-commercezone	e-commercezone	ZNW:EKV:DE_
e-maildossier	e-maildossier	ZNW:EKV:HET
pc-winkeltje	pc-winkeltje	ZNW:EKV:VRK:HET
e-mailavonden	e-mailavonden	ZNW:MRV:DE_
pr-veldtocht	pr-veldtocht	ZNW:EKV:DE_
e-commerce-pakketten	e-commerce-pakketten	ZNW:MRV:DE_
btw-criteria	btw-criteria	ZNW:MRV:DE_
wc-stuursystemen	wc-stuursystemen	ZNW:MRV:DE_
btw-model	btw-model	ZNW:EKV:HET
wc-schoonmaakmiddel	wc-schoonmaakmiddel	ZNW:EKV:HET
e-commerceconsultants	e-commerceconsultant	ZNW:MRV:DE_
e-learning-instructie	e-learning-instructie	ZNW:EKV:DE_
e-mail-fiasco	e-mail-fiasco	ZNW:EKV:HET
e-mailadrescontrole	e-mailadrescontrole	ZNW:EKV:DE_
e-overheidsinfra-samenleving	e-overheidsinfra-samenleving	ZNW:EKV:DE_
e-commercerapporten	e-commercerapport	ZNW:MRV:DE_
e-commerce-deals	e-commerce-deals	ZNW:MRV:DE_
wc-kraantje	wc-kraantje	ZNW:EKV:VRK:HET
pr-burgemeester	pr-burgemeester	ZNW:EKV:DE_
e-mailmarketingagentschap	e-mailmarketingagentschap	ZNW:EKV
e-commerce-jongens	e-commerce-jongens	ZNW:MRV:DE_
wc-gereedschap	wc-gereedschap	ZNW:EKV
e-commerce-reuzen	e-commerce-reuzen	ZNW:MRV:DE_
btw-schuldvordering	btw-schuldvordering	ZNW:EKV:DE_
e-commercepark	e-commercepark	ZNW:EKV:HET
standaard-btw-code	standaard-btw-code	ZNW:EKV:DE_
e-mailaccountnaam	e-mailaccountnaam	ZNW:EKV:DE_
pc-website	pc-website	ZNW:EKV:DE_
e-mailverspreiding	e-mailverspreiding	ZNW:EKV:DE_
e-mailconflicten	e-mailconflicten	ZNW:MRV:DE_
btw-aftrekuitsluiting	btw-aftrekuitsluiting	ZNW:EKV:DE_
pc-tafeltje	pc-tafeltje	ZNW:EKV:VRK:HET
pc-venster	pc-venster	ZNW:EKV:HET
e-commercegedeelte	e-commercegedeelte	ZNW:EKV:HET
gsm-telefoonmasten	gsm-telefoonmasten	ZNW:MRV:DE_
e-mailbeveiligingsbeleid	e-mailbeveiligingsbeleid	ZNW:EKV:HET
pc-vervangers	pc-vervangers	UNSPECIFIED
wc-reglement	wc-reglement	ZNW:EKV:HET
pc-plannen	pc-plannen	ZNW:MRV:DE_
e-commercetraject	e-commercetraject	ZNW:EKV:HET
e-commerce-winkelier	e-commerce-winkelier	ZNW:EKV:DE_
wc-wastafel	wc-wastafel	ZNW:EKV:DE_
pc-gamebladen	pc-gamebladen	ZNW:MRV:DE_
e-mailmarketingevenementen	e-mailmarketingevenementen	ZNW:MRV:DE_
kenners-gsm-overleg	kenners-gsm-overleg	ZNW:EKV:HET
pc-aanbod	pc-aanbod	ZNW:EKV:HET
pc-activiteit	pc-activiteit	ZNW:EKV:DE_
pc-branche	pc-branche	ZNW:EKV:DE_
pc-bureaublad	pc-bureaublad	ZNW:EKV:HET
pc-contact	pc-contact	ZNW:EKV:HET
pc-dienst	pc-dienst	ZNW:EKV:DE_
pc-expert	pc-expert	ZNW:EKV:DE_
pc-faciliteiten	pc-faciliteiten	ZNW:MRV:DE_
pc-formaat	pc-formaat	ZNW:EKV:HET
pc-gebruikersrechten	pc-gebruikersrechten	ZNW:MRV:DE_
pc-gehalte	pc-gehalte	ZNW:EKV:HET
pc-installatie	pc-installatie	ZNW:EKV:DE_
pc-kaartsleuf	pc-kaartsleuf	ZNW:EKV:DE_
pc-leveringen	pc-leveringen	ZNW:MRV:DE_
pc-liefhebbers	pc-liefhebbers	ZNW:MRV:DE_
pc-materiaal	pc-materiaal	ZNW:EKV:HET
pc-moederborden	pc-moederbord	ZNW:MRV:DE_
pc-opleidingen	pc-opleidingen	ZNW:MRV:DE_
pc-prijslijst	pc-prijslijst	ZNW:EKV:DE_
pc-producten	pc-producten	ZNW:MRV:DE_
pc-regel	pc-regel	ZNW:EKV:DE_
gsm-opstelpunten	gsm-opstelpunten	ZNW:MRV:DE_
pc-serie	pc-serie	ZNW:EKV:DE_
pc-service	pc-service	ZNW:EKV:DE_
pc-speeltje	pc-speeltje	ZNW:EKV:VRK:HET
pc-toestellen	pc-toestellen	ZNW:MRV:DE_
pc-toetsen	pc-toetsen	ZNW:MRV:DE_
pc-voorziening	pc-voorziening	ZNW:EKV:DE_
e-mailbeveiligingsmodule	e-mailbeveiligingsmodule	ZNW:EKV:DE_
e-maildieet	e-maildieet	ZNW:EKV:HET
pr-jaarverslagen	pr-jaarverslagen	ZNW:MRV:DE_
e-mailmarketing-partijen	e-mailmarketing-partijen	ZNW:MRV:DE_
pc-basisschool	pc-basisschool	ZNW:EKV:DE_
pc-plaats	pc-plaats	ZNW:EKV:DE_
e-mailbezwaar	e-mailbezwaar	ZNW:EKV:HET
btw-notering	btw-notering	ZNW:EKV:DE_
pr-commissielid	pr-commissielid	ZNW:EKV:HET
pc-samenwerking	pc-samenwerking	ZNW:EKV:DE_
e-mail-cliÃ«nt	e-mail-cliÃ«nt	ZNW:EKV:DE_
e-commerce-specialisten	e-commerce-specialisten	ZNW:MRV:DE_
e-boekenstad	e-boekenstad	ZNW:EKV:DE_
wc-rollen-kanon	wc-rollen-kanon	ZNW:EKV:HET
e-commerce-uitdaging	e-commerce-uitdaging	ZNW:EKV:DE_
e-commerce-implementaties	e-commerce-implementaties	ZNW:MRV:DE_
pc-antivirusproducten	pc-antivirusproducten	ZNW:MRV:DE_
gsm-muziek	gsm-muziek	ZNW:EKV:DE_
btw-aangifteregels	btw-aangifteregels	ZNW:MRV:DE_
e-commercemiddelen	e-commercemiddelen	ZNW:MRV:DE_
wc-afspraken	wc-afspraken	ZNW:MRV:DE_
wc-lucht	wc-lucht	ZNW:EKV:DE_
e-mail-tijd	e-mail-tijd	ZNW:EKV:DE_
wc-onderdeel	wc-onderdeel	ZNW:EKV:HET
btw-aftrekregels	btw-aftrekregels	ZNW:MRV:DE_
design-wc-borstels	design-wc-borstels	ZNW:MRV:DE_
pr-benadering	pr-benadering	ZNW:EKV:DE_
pr-boek	pr-boek	ZNW:EKV:HET
pr-crisis	pr-crisis	ZNW:EKV:DE_
pr-dagen	pr-dagen	ZNW:MRV:DE_
pr-omgeving	pr-omgeving	ZNW:EKV:DE_
pr-sausje	pr-sausje	ZNW:EKV:VRK:HET
pr-verhalen	pr-verhalen	ZNW:MRV:DE_
e-mailmarketingsegment	e-mailmarketingsegment	ZNW:EKV:HET
pc-gameblad	pc-gameblad	ZNW:EKV:HET
wc-plaat	wc-plaat	ZNW:EKV:DE_
btw-actieplan	btw-actieplan	ZNW:EKV:HET
e-commerce-analist	e-commerce-analist	ZNW:EKV:DE_
kantoorpr-commissie	kantoorpr-commissie	ZNW:EKV:DE_
btw-compensatieproblematiek	btw-compensatieproblematiek	ZNW:EKV:DE_
gsm-zendertje	gsm-zendertje	ZNW:EKV:VRK:HET
e-mailmarketing-strategie	e-mailmarketing-strategie	ZNW:EKV:DE_
e-commerceaanbiedingen	e-commerceaanbiedingen	ZNW:MRV:DE_
pc-gebruiksaanwijzingen	pc-gebruiksaanwijzingen	ZNW:MRV:DE_
e-learningonderdelen	e-learningonderdelen	ZNW:MRV:DE_
e-mailcase	e-mailcase	ZNW:EKV:DE_
gsm-wachtsysteem	gsm-wachtsysteem	ZNW:EKV:HET
e-commerce-dienstverleners	e-commerce-dienstverleners	ZNW:MRV:DE_
e-boekenzaak	e-boekenzaak	ZNW:EKV:DE_
e-commercetijd	e-commercetijd	ZNW:EKV:DE_
e-boekenpakket	e-boekenpakket	ZNW:EKV:HET
e-boekenprijs	e-boekenprijs	ZNW:EKV:DE_
e-learningsfilmpjes	e-learningsfilmpjes	ZNW:MRV:VRK:DE_
e-learningvideo	e-learningvideo	ZNW:EKV:DE_
btw-fraudebestrijdingseenheden	btw-fraudebestrijdingseenheden	ZNW:MRV:DE_
e-mailgebruiken	e-mailgebruiken	ZNW:MRV:DE_
e-mailserviceformulier	e-mailserviceformulier	ZNW:EKV:HET
e-mailmarketingresultaten	e-mailmarketingresultaten	ZNW:MRV:DE_
e-commerce-opbrengst	e-commerce-opbrengst	ZNW:EKV:DE_
pc-technische	pc-technische	BNW:STL:VRB
e-maildictatuur	e-maildictatuur	ZNW:EKV:DE_
pc-reparatiebedrijf	pc-reparatiebedrijf	ZNW:EKV:HET
e-mailnieuwsdienst	e-mailnieuwsdienst	ZNW:EKV:DE_
wc-modellen	wc-modellen	ZNW:MRV:DE_
flatscreen-breedbeeld-tv	flatscreen-breedbeeld-tv	ZNW:EKV:DE_
wc-fabriek	wc-fabriek	ZNW:EKV:DE_
btw-facturatieregels	btw-facturatieregels	ZNW:MRV:DE_
e-commercebetalingen	e-commercebetalingen	ZNW:MRV:DE_
e-boekensite	e-boekensite	ZNW:EKV:DE_
btw-wereld	btw-wereld	ZNW:EKV:DE_
e-mailblokkades	e-mailblokkades	ZNW:MRV:DE_
btw-leveringsmodel	btw-leveringsmodel	ZNW:EKV:HET
e-mailmatch	e-mailmatch	ZNW:EKV:DE_
pr-ervaring	pr-ervaring	ZNW:EKV:DE_
btw-instellingen	btw-instellingen	ZNW:MRV:DE_
e-commerce-wetgeving	e-commerce-wetgeving	ZNW:EKV:DE_
e-mailcorrespondente	e-mailcorrespondente	ZNW:EKV:DE_
e-commercecampagnes	e-commercecampagnes	ZNW:MRV:DE_
wc-stortplaats	wc-stortplaats	ZNW:EKV:DE_
gsm-videobeelden	gsm-videobeelden	ZNW:MRV:DE_
gsm-laadstation	gsm-laadstation	ZNW:EKV:HET
e-mailkopie	e-mailkopie	ZNW:EKV:DE_
e-commerceapparaat	e-commerceapparaat	ZNW:EKV:HET
pc-gametijdschrift	pc-gametijdschrift	ZNW:EKV:HET
e-mailicoon	e-mailicoon	ZNW:EKV:DE_
e-mailtraject	e-mailtraject	ZNW:EKV:HET
btw-heffingsmaatstaf	btw-heffingsmaatstaf	ZNW:EKV:DE_
e-mailmarketingvormen	e-mailmarketingvormen	ZNW:MRV:DE_
wc-rapport	wc-rapport	ZNW:EKV:HET
pr-oefening	pr-oefening	ZNW:EKV:DE_
btw-ondernemersactiviteiten	btw-ondernemersactiviteiten	ZNW:MRV:DE_
pr-communicatiebureaus	pr-communicatiebureaus	ZNW:MRV:DE_
pc-dienstverlening	pc-dienstverlening	ZNW:EKV:DE_
pr-teams	pr-teams	ZNW:MRV:DE_
e-commerceregeling	e-commerceregeling	ZNW:EKV:DE_
e-mailinspanningen	e-mailinspanningen	ZNW:MRV:DE_
wc-specialist	wc-specialist	ZNW:EKV:DE_
e-commercebenadering	e-commercebenadering	ZNW:EKV:DE_
btw-route	btw-route	ZNW:EKV:DE_
pr-motor	pr-motor	ZNW:EKV:DE_
e-mailvloed	e-mailvloed	ZNW:EKV:DE_
e-commerce-terrein	e-commerce-terrein	ZNW:EKV:HET
e-mailaccounthouders	e-mailaccounthouders	ZNW:MRV:DE_
mini-pc-keyboards	mini-pc-keyboards	ZNW:MRV:DE_
e-mailidentiteit	e-mailidentiteit	ZNW:EKV:DE_
e-learningbeleid	e-learningbeleid	ZNW:EKV:HET
e-mailtoezegging	e-mailtoezegging	ZNW:EKV:DE_
e-mailsignalering	e-mailsignalering	ZNW:EKV:DE_
e-commerceleveringen	e-commerceleveringen	ZNW:MRV:DE_
e-mailontwerper	e-mailontwerper	ZNW:EKV:DE_
btw-premie	btw-premie	ZNW:EKV:DE_
e-commerce-functionaliteiten	e-commerce-functionaliteiten	ZNW:MRV:DE_
e-learningfilmpjes	e-learningfilmpjes	ZNW:MRV:VRK:DE_
pr-hoogte	pr-hoogte	ZNW:EKV:DE_
e-mailschrijfster	e-mailschrijfster	ZNW:EKV:DE_
pr-prijs	pr-prijs	ZNW:EKV:DE_
btw-wetsvoorstellen	btw-wetsvoorstellen	ZNW:MRV:DE_
e-learning-training	e-learning-training	ZNW:EKV:DE_
btw-artikelen	btw-artikelen	ZNW:MRV:DE_
e-mail-gesprek	e-mail-gesprek	ZNW:EKV:HET
wc-liedje	wc-liedje	ZNW:EKV:VRK:HET
e-commerce-aanbieders	e-commerce-aanbieders	ZNW:MRV:DE_
e-mailplanning	e-mailplanning	ZNW:EKV:DE_
e-mail-marketing-software	e-mail-marketing-software	ZNW:EKV:DE_
e-maildoelstelling	e-maildoelstelling	ZNW:EKV:DE_
pc-verkoopprijs	pc-verkoopprijs	ZNW:EKV:DE_
e-mailsupportlijn	e-mailsupportlijn	ZNW:EKV:DE_
e-learning-revolutie	e-learning-revolutie	ZNW:EKV:DE_
wc-boek	wc-boek	ZNW:EKV:HET
pc-medewerker	pc-medewerker	ZNW:EKV:DE_
gsm-oplaadhouders	gsm-oplaadhouders	ZNW:MRV:DE_
pc-zieltje	pc-zieltje	ZNW:EKV:VRK:HET
e-mailhandtekeningenbeheer	e-mailhandtekeningenbeheer	ZNW:EKV:HET
pc-tests	pc-tests	ZNW:MRV:DE_
e-boekencollectie	e-boekencollectie	ZNW:EKV:DE_
e-mailverwerkingsfabriek	e-mailverwerkingsfabriek	ZNW:EKV:DE_
e-commerce-medewerker	e-commerce-medewerker	ZNW:EKV:DE_
gsm-service	gsm-service	ZNW:EKV:DE_
btw-heffingsaanslagen	btw-heffingsaanslagen	ZNW:MRV:DE_
e-mailreferenties	e-mailreferenties	ZNW:MRV:DE_
e-mailmarketingboodschappen	e-mailmarketingboodschappen	ZNW:MRV:DE_
e-maillay-outs	e-maillay-outs	ZNW:MRV:DE_
pc-moederbord	pc-moederbord	ZNW:EKV:HET
e-commercedeskundigen	e-commercedeskundigen	ZNW:MRV:DE_
e-mailopvolgsysteem	e-mailopvolgsysteem	ZNW:EKV:HET
e-mailserverschandaal	e-mailserverschandaal	ZNW:EKV:HET
pc-marktaandeel	pc-marktaandeel	ZNW:EKV:HET
gsm-netwerkproviders	gsm-netwerkprovider	ZNW:MRV:DE_
e-mailregistratieproces	e-mailregistratieproces	ZNW:EKV:HET
pr-manier	pr-manier	ZNW:EKV
standaard-btw-aangifte	standaard-btw-aangifte	ZNW:EKV:DE_
e-mailadresverificatie	e-mailadresverificatie	ZNW:EKV:DE_
wc-brillenverkoper	wc-brillenverkoper	ZNW:EKV:DE_
wc-venster	wc-venster	ZNW:EKV:HET
gsm-zaken	gsm-zaken	ZNW:MRV:DE_
gsm-lijst	gsm-lijst	ZNW:EKV:DE_
e-commerce-integrator	e-commerce-integrator	ZNW:EKV:DE_
e-mailmarketing-toepassingen	e-mailmarketing-toepassingen	ZNW:MRV:DE_
e-commerce-pagina	e-commerce-pagina	ZNW:EKV:DE_
e-commerce-verantwoordelijken	e-commerce-verantwoordelijken	ZNW:MRV:DE_
pc-kleurenschema	pc-kleurenschema	ZNW:EKV:HET
btw-leveringen	btw-leveringen	ZNW:MRV:DE_
e-learningteam	e-learningteam	ZNW:EKV:HET
e-mailwedstrijd	e-mailwedstrijd	ZNW:EKV:DE_
e-mailbundeling	e-mailbundeling	ZNW:EKV:DE_
pc-marktbepalende	pc-marktbepalende	ZNW:EKV:DE_
pc-installatieprogramma	pc-installatieprogramma	ZNW:EKV:HET
wc-rollen-uitstraling	wc-rollen-uitstraling	ZNW:EKV:DE_
e-commercecentrum	e-commercecentrum	ZNW:EKV:HET
douche-wc-combinatie	douche-wc-combinatie	ZNW:EKV:DE_
e-mailgeheugen	e-mailgeheugen	ZNW:EKV:HET
btw-actievoordeel	btw-actievoordeel	ZNW:EKV:HET
e-mailbewerkingen	e-mailbewerking	ZNW:MRV:DE_
pc-powermanagementsysteem	pc-powermanagementsysteem	ZNW:EKV:HET
gsm-netwerkoperatoren	gsm-netwerkoperator	ZNW:MRV:DE_
e-commercefunctie	e-commercefunctie	ZNW:EKV:DE_
e-mailbudget	e-mailbudget	ZNW:EKV:HET
e-boekenland	e-boekenland	ZNW:EKV:HET
pr-vakantieartikel	pr-vakantieartikel	ZNW:EKV:HET
btw-analysemodel	btw-analysemodel	ZNW:EKV:HET
wc-regime	wc-regime	ZNW:EKV:HET
btw-scenario	btw-scenario	ZNW:EKV:HET
e-mail-apparaat	e-mail-apparaat	ZNW:EKV:HET
pr-software	pr-software	ZNW:EKV:DE_
e-commerceconsultant	e-commerceconsultant	ZNW:EKV:DE_
wc-pottenbakker	wc-pottenbakker	ZNW:EKV:DE_
pr-stukje	pr-stukje	ZNW:EKV:VRK:HET
e-boeken-project	e-boeken-project	ZNW:EKV:HET
btw-goedkeuring	btw-goedkeuring	ZNW:EKV:DE_
e-commercegroeier	e-commercegroeier	ZNW:EKV:DE_
e-mailblokken	e-mailblokken	ZNW:MRV:DE_
e-mailvormen	e-mailvormen	ZNW:MRV:DE_
standaard-btw-tarief	standaard-btw-tarief	ZNW:EKV:HET
douche-wc-functies	douche-wc-functies	ZNW:MRV:DE_
btw-bijdrageplicht	btw-bijdrageplicht	ZNW:EKV:DE_
e-mailchaos	e-mailchaos	ZNW:EKV:DE_
wc-krant	wc-krant	ZNW:EKV:DE_
e-mailopbouw	e-mailopbouw	ZNW:EKV:DE_
e-maildatabaserecords	e-maildatabaserecords	ZNW:MRV:DE_
e-mailbeveiligingsdienst	e-mailbeveiligingsdienst	ZNW:EKV:DE_
wc-papiercape	wc-papiercape	ZNW:EKV:DE_
pr-plaats	pr-plaats	ZNW:EKV:DE_
btw-uitvoerings-verordening	btw-uitvoerings-verordening	ZNW:EKV:DE_
e-mail-terreur	e-mail-terreur	ZNW:EKV:DE_
e-mailcentrum	e-mailcentrum	ZNW:EKV:HET
e-mailmarketingdienst	e-mailmarketingdienst	ZNW:EKV:DE_
e-mailmarketingvorm	e-mailmarketingvorm	ZNW:EKV:DE_
superbreedbeeld-tv	superbreedbeeld-tv	ZNW:EKV:DE_
pr-feestje	pr-feestje	ZNW:EKV:VRK:HET
gsm-actie	gsm-actie	ZNW:EKV:DE_
e-mailbewaking	e-mailbewaking	ZNW:EKV:DE_
e-mailhistoriek	e-mailhistoriek	ZNW:EKV:DE_
e-mailreferendum	e-mailreferendum	ZNW:EKV:HET
pc-insteekkaartje	pc-insteekkaartje	ZNW:EKV:VRK:HET
e-commercelicentie	e-commercelicentie	ZNW:EKV:DE_
e-commerce-infrastructuur	e-commerce-infrastructuur	ZNW:EKV:DE_
btw-optieverzoek	btw-optieverzoek	ZNW:EKV:HET
e-mailcascade	e-mailcascade	ZNW:EKV:DE_
wc-pakket	wc-pakket	ZNW:EKV:HET
e-mailtijden	e-mailtijd	ZNW:MRV:DE_
pc-prijs	pc-prijs	ZNW:EKV:DE_
e-overheidsvoorziening	e-overheidsvoorziening	ZNW:EKV:DE_
pc-fondsen	pc-fondsen	ZNW:MRV:DE_
e-mailmarketingstudie	e-mailmarketingstudie	ZNW:EKV:DE_
e-mailvergadering	e-mailvergadering	ZNW:EKV:DE_
btw-vrijstellingsregel	btw-vrijstellingsregel	ZNW:EKV:DE_
btw-adviesbureau	btw-adviesbureau	ZNW:EKV:HET
gsm-normen	gsm-normen	ZNW:MRV:DE_
e-commercestunt	e-commercestunt	ZNW:EKV:DE_
pc-soort	pc-soort	ZNW:EKV
wc-sturingen	wc-sturingen	ZNW:MRV:DE_
pc-ecosysteem	pc-ecosysteem	ZNW:EKV:HET
gsm-fototoestel	gsm-fototoestel	ZNW:EKV:HET
pc-contract	pc-contract	ZNW:EKV:HET
e-mailadres-herkenning	e-mailadres-herkenning	ZNW:EKV:DE_
e-mailstapel	e-mailstapel	ZNW:EKV:DE_
e-commercevakblad	e-commercevakblad	ZNW:EKV:HET
e-commerce-markten	e-commerce-markten	ZNW:MRV:DE_
wc-papierproducent	wc-papierproducent	ZNW:EKV:DE_
e-mailmateriaal	e-mailmateriaal	ZNW:EKV:HET
pr-investeringen	pr-investeringen	ZNW:MRV:DE_
e-commerce-technieken	e-commerce-technieken	ZNW:MRV:DE_
e-learningicoon	e-learningicoon	ZNW:EKV:DE_
e-mailstemming	e-mailstemming	ZNW:EKV:DE_
e-mail-producten	e-mail-producten	ZNW:MRV:DE_
wc-beleid	wc-beleid	ZNW:EKV:HET
wc-groepen	wc-groepen	ZNW:MRV:DE_
wc-rollengevecht	wc-rollengevecht	ZNW:EKV:HET
wc-venstertje	wc-venstertje	ZNW:EKV:VRK:HET
gsm-basisstations	gsm-basisstation	ZNW:MRV:DE_
m.v.g.	m.v.g.	TSW
URL's	URL	ZNW:MRV:DE_
vof's	vof	ZNW:MRV:DE_
m's	m	ZNW:MRV:DE_
r's	r	ZNW:MRV:DE_
clearings	clearing	ZNW:MRV:DE_
paspel	paspel	ZNW:EKV:HET
wijste	wijs	BNW:OVR:VRB
anti-Spaanse	anti-Spaans	BNW:STL:VRB
anti-Macedonische	anti-Macedonisch	BNW:STL:VRB
antimarxistisch	antimarxistisch	BNW:STL:ONV
antimarxistische	antimarxistisch	BNW:STL:VRB
Habsburgse	Habsburgs	BNW:STL:VRB
dekzijde	dekzijde	ZNW:EKV:DE_
lichtroze	lichtroze	BNW:STL:ONV
veelbloemige	veelbloemig	BNW:STL:VRB
eek	eken	WKW:TGW:1EP
geÃ«ekt	eken	WKW:VTD:ONV
ekend	eken	WKW:ODW:ONV
ekende	eken	WKW:ODW:VRB
eekt	eken	WKW:TGW:3EP
eindzet	eindzet	ZNW:EKV:DE_
eindzetje	eindzet	ZNW:EKV:VRK:HET
zomerdroogte	zomerdroogte	ZNW:EKV:DE_
zomerdroogten	zomerdroogte	ZNW:MRV:DE_
puja	puja	ZNW:EKV:DE_
puja's	puja	ZNW:MRV:DE_
gyms	gym	ZNW:MRV:DE_
fisis	fisis	ZNW:EKV:DE_
cliÃ«ntgerichter	cliÃ«ntgericht	BNW:VGR:ONV
winken	wink	ZNW:MRV:DE_
ecoboer	ecoboer	ZNW:EKV:DE_
ecoboeren	ecoboer	ZNW:MRV:DE_
mo-akten	mo-akte	ZNW:MRV:DE_
mo-aktes	mo-akte	ZNW:MRV:DE_
woon-zorgcomplex	woon-zorgcomplex	ZNW:EKV:HET
tencel	tencel	ZNW:EKV
eisalade	eisalade	ZNW:EKV:DE_
quala	quala	ZNW:EKV:DE_
quala's	quala	ZNW:MRV:DE_
dievengilden	dievengilde	ZNW:MRV:DE_
dievengildes	dievengilde	ZNW:MRV:DE_
opluisteringen	opluistering	ZNW:MRV:DE_
buiten	buiten	VRZ
passok	passok	ZNW:EKV:DE_
passokjes	passok	ZNW:MRV:VRK:DE_
passokken	passok	ZNW:MRV:DE_
gyttja	gyttja	ZNW:EKV
obducent	obducent	ZNW:EKV:DE_
obducenten	obducent	ZNW:MRV:DE_
sokmaat	sokmaat	ZNW:EKV:DE_
sokmaten	sokmaat	ZNW:MRV:DE_
mesrand	mesrand	ZNW:EKV:DE_
