# deleted postag entries
#-------------------------------------------------------------------------------
# Do not add words here, but report them to languagetool@taaltik.nl
#-------------------------------------------------------------------------------
aanlegvlak	aanlegvlak	BNW:STL:ONV
aanplantgrond	aanplantgrond	BNW:STL:ONV
aanrijdafstand	aanrijdafstand	ZNW:EKV:DE_
aanrijdbelasting	aanrijdbelasting	ZNW:EKV:DE_
aanrijdbeschermers	aanrijdbeschermer	ZNW:MRV:DE_
aanrijdbescherming	aanrijdbescherming	ZNW:EKV:DE_
aanrijdbeveiliging	aanrijdbeveiliging	ZNW:EKV:DE_
aanrijdbeveiligingen	aanrijdbeveiliging	ZNW:MRV:DE_
aanrijdgevaar	aanrijdgevaar	ZNW:EKV:HET
aanrijdprofiel	aanrijdprofiel	ZNW:EKV:HET
aanrijdrichting	aanrijdrichting	ZNW:EKV:DE_
aanrijdrichtingen	aanrijdrichting	ZNW:MRV:DE_
aanrijdrisico	aanrijdrisico	ZNW:EKV
aanrijdrisico's	aanrijdrisico	ZNW:MRV:DE_
aanrijdroute	aanrijdroute	ZNW:EKV:DE_
aanrijdroutes	aanrijdroute	ZNW:MRV:DE_
aanrijdschade	aanrijdschade	ZNW:EKV:DE_
aanrijdsnelheid	aanrijdsnelheid	ZNW:EKV:DE_
aansturingsunit	aansturingsunit	ZNW:EKV
aanvraagknoppen	aanvraagknop	ZNW:EKV
aartsluiaards	aartsluiaards	BNW:STL:ONV
abdijencomplex	abdijencomplex	BNW:STL:ONV
achteraangelopen	achteraanlopen	WKW:VTD:ONV
achteraanloopt	achteraanlopen	WKW:TGW:3EP
achteraanlopen	achteraanlopen	WKW:TGW:INF
achtergehangen	achterhangen	WKW:VTD:ONV
achterhangen	achterhang	ZNW:MRV:DE_
achterhangen	achterhangen	WKW:TGW:INF
achterhangende	achterhangen	WKW:ODW:VRB
achterhangt	achterhangen	WKW:TGW:3EP
achterhingen	achterhangen	WKW:VLT:INF
achterhoeden	achterhoed	ZNW:MRV:DE_
achternagezet	achternazetten	WKW:VTD:ONV
acrylamides	acrylamide	ZNW:EKV
advertentievrije	advertentievrije	BNW:STL:VRB
afdekgrond	afdekgrond	BNW:STL:ONV
afgeknutseld	afgeknutseld	BNW:STL:ONV
aftelliedje	aftelliedje	ZNW:EKV:VRK:HET
alleenlijk	alleenlijk	BNW:STL:ONV
alleenlijke	alleenlijk	BNW:STL:VRB
allengs	allengs	UNSPECIFIED
allesverwoestende	allesverwoestende	BNW:STL:VRB
antennerelais	antennerelais	ZNW:MRV:DE_
anti-techniek	anti-techniek	BNW:STL:ONV
anti-zwart	anti-zwart	BNW:STL:ONV
anti-zwarte	anti-zwart	BNW:STL:VRB
aquariumlampen	aquariumlamp	ZNW:EKV
arbeiderskampen	arbeiderskamp	ZNW:EKV
artikelstam	artikelstam	BNW:STL:ONV
artsenbestand	artsenbestand	BNW:STL:ONV
aspergeveld	aspergeveld	BNW:STL:ONV
aspergevelden	aspergeveld	BNW:STL:MRV:DE_
audiogebruik	audiogebruik	BNW:STL:ONV
avondbries	avondbries	ZNW:MRV:DE_
bacoven	bacove	ZNW:MRV:DE_
bandenzwart	bandenzwart	BNW:STL:ONV
basketbaltrots	basketbaltrots	BNW:STL:ONV
bedektelijk	bedektelijk	BNW:STL:ONV
behandeltrouw	behandeltrouw	BNW:STL:ONV
bekenbaar	bekenbaar	BNW:STL:ONV
bekenbare	bekenbaar	BNW:STL:VRB
belangenveld	belangenveld	BNW:STL:ONV
belangloos	belangloos	BNW:STL:ONV
beleidsrelevante	beleidsrelevante	BNW:STL:VRB
bepaaldelijk	bepaaldelijk	BNW:STL:ONV
bepaaldelijke	bepaaldelijk	BNW:STL:VRB
bermbommen	bermbommen	ZNW:EKV
bermbommen	bermbommen	ZNW:MRV:DE_
bermbommetje	bermbommen	ZNW:EKV:VRK:HET
bermbommetjes	bermbommen	ZNW:MRV:VRK:DE_
bestevaar	bestevaar	BNW:STL:ONV
betongebruik	betongebruik	BNW:STL:ONV
bierdrinken	bierdrinken	WKW:INF:ZNW:HET
bijbelgetrouw	bijbelgetrouw	BNW:STL:ONV
billijkerwijs	billijkerwijs	BNW:STL:ONV
bitmapbestand	bitmapbestand	BNW:STL:ONV
blaakbaar	blaakbaar	BNW:STL:ONV
blasfemistische	blasfemistische	BNW:STL:VRB
boerderijstroken	boerderijstrook	ZNW:MRV:DE
boerenkarren	boerenkarren	ZNW:EKV
boerenkarren	boerenkarren	ZNW:MRV:DE_
boerenkarretjes	boerenkarren	ZNW:MRV:VRK:DE_
boerenleed	boerenleed	BNW:STL:ONV
boerentrots	boerentrots	BNW:STL:ONV
boluslaag	boluslaag	BNW:STL:ONV
bomenklem	bomenklem	BNW:STL:ONV
bomenrijkdom	bomenrijkdom	BNW:STL:ONV
bonje	bonje	ZNW:EKV:VRK:HET
bonuscontent	bonuscontent	BNW:STL:ONV
bonustarief	bonustarief	BNW:STL:ONV
boortoren	boortoren	ZNW:MRV:DE_
bossencomplex	bossencomplex	BNW:STL:ONV
bovengericht	bovengericht	BNW:STL:ONV
breekstuk	breekstuk	BNW:STL:ONV
breekvlak	breekvlak	BNW:STL:ONV
bridgetitel	bridgetitel	BNW:STL:ONV
briefstuk	briefstuk	BNW:STL:ONV
broederlief	broederlief	BNW:STL:ONV
broomzuur	broomzuur	BNW:STL:ONV
bruinkoollagen	bruinkoollaag	BNW:STL:MRV:DE_
budgettechnisch	budgettechnisch	BNW:STL:ONV
buikwanddefect	buikwanddefect	BNW:STL:ONV
buisdefect	buisdefect	BNW:STL:ONV
buisdefecten	buisdefect	BNW:STL:MRV:DE_
buitenbewust	buitenbewust	BNW:STL:ONV
buitenwaard	buitenwaard	BNW:STL:ONV
burgerschouw	burgerschouw	BNW:STL:ONV
buxusgrond	buxusgrond	BNW:STL:ONV
cafeïnegebruik	cafeïnegebruik	BNW:STL:ONV
calciumparadox	calciumparadox	BNW:STL:ONV
cameljas	cameljas	ZNW:MRV:DE_
canadagans	canadagans	BNW:STL:ONV
canadaganzen	canadagans	BNW:STL:MRV:DE_
carbonlaag	carbonlaag	BNW:STL:ONV
categorietitel	categorietitel	BNW:STL:ONV
cellovirtuoos	cellovirtuoos	BNW:STL:ONV
chaptaliseren	chaptaliseren	WKW:INF:ZNW:HET
chocoladen	chocoladen	BNW:STL:ONV
chocotelegram	chocotelegram	BNW:STL:ONV
chromatiek	chromatiek	BNW:STL:ONV
co-commentatoren	co-commentator	ZNW:MRV:DE_
commensaals	commensaals	BNW:STL:ONV
computertips	computertips	BNW:STL:ONV
conflictmijdende	conflictmijdende	BNW:STL:VRB
contrastkleurig	contrastkleurig	BNW:STL:ONV
contrastkleurige	contrastkleurig	BNW:STL:VRB
cruisetarief	cruisetarief	BNW:STL:ONV
cruisetarieven	cruisetarief	BNW:STL:MRV:DE_
cultuurdruk	cultuurdruk	BNW:STL:ONV
cultuurweek	cultuurweek	BNW:STL:ONV
cyclosporines	cyclosporine	ZNW:MRV:DE_
damestextiel	damestextiel	BNW:STL:ONV
defensievlak	defensievlak	BNW:STL:ONV
derbystar	derbystar	BNW:STL:ONV
derdehalf	derdehalf	BNW:STL:ONV
derdehalve	derdehalf	BNW:STL:VRB
desverzocht	desverzocht	BNW:STL:ONV
deurluifel	deurluifel	BNW:STL:ONV
deux-pièces	deux-pièces	ZNW:EKV:DE_
diabetesduur	diabetesduur	BNW:STL:ONV
dichtbaar	dichtbaar	BNW:STL:ONV
dichtwonder	dichtwonder	BNW:STL:ONV
dieettrouw	dieettrouw	BNW:STL:ONV
dienstjas	dienstjas	ZNW:MRV:DE_
dieseldief	dieseldief	BNW:STL:ONV
dieselvlak	dieselvlak	BNW:STL:ONV
discogram	discogram	BNW:STL:ONV
discretionair	discretionair	ZNW:EKV
discussietips	discussietips	BNW:STL:ONV
disseldruk	disseldruk	BNW:STL:ONV
dodengericht	dodengericht	BNW:STL:ONV
doelgroepstroken	doelgroepstrook	ZNW:MRV:DE
doktersjas	doktersjas	ZNW:MRV:DE_
donderblauw	donderblauw	BNW:STL:ONV
donderbruin	donderbruin	BNW:STL:ONV
donderochtend	donderochtend	BNW:STL:ONV
donsjas	donsjas	ZNW:MRV:DE_
doodmoede	doodmoede	BNW:STL:ONV
doorgaands	doorgaands	BNW:STL:ONV
doorreistarief	doorreistarief	BNW:STL:ONV
dorpsgrond	dorpsgrond	BNW:STL:ONV
douchegeel	douchegeel	BNW:STL:ONV
draadstuk	draadstuk	BNW:STL:ONV
draaglaag	draaglaag	BNW:STL:ONV
draaiweek	draaiweek	BNW:STL:ONV
drachtduur	drachtduur	BNW:STL:ONV
dressuurtitel	dressuurtitel	BNW:STL:ONV
dringbaar	dringbaar	BNW:STL:ONV
droogscheer	droogscheren	WKW:TGW:1EP
droogscheren	droogscheren	WKW:TGW:INF
dubbelstuk	dubbelstuk	BNW:STL:ONV
duinmassief	duinmassief	BNW:STL:ONV
duizend-en-een-nachten	duizend-en-een-nacht	ZNW:MRV:DE_
dwergenrijk	dwergenrijk	BNW:STL:ONV
eendelijk	eendelijk	BNW:STL:ONV
eendelijke	eendelijk	BNW:STL:VRB
eenheidsrijk	eenheidsrijk	BNW:STL:ONV
eigenlijks	eigenlijks	BNW:STL:ONV
eikenbestand	eikenbestand	BNW:STL:ONV
eikenbestanden	eikenbestand	BNW:STL:MRV:DE_
eindejaartips	eindejaartips	BNW:STL:ONV
eindgericht	eindgericht	BNW:STL:ONV
elfendertig	elfendertig	BNW:STL:ONV
elfstedenstadje	elfstedenstad	ZNW:EKV:VRK:HET
emeritus-hoogleraren	emeritus-hoogleraar	ZNW:MRV:DE_
energiejas	energiejas	ZNW:MRV:DE_
engelenlicht	engelenlicht	BNW:STL:ONV
enzymdefect	enzymdefect	BNW:STL:ONV
euroloodvrij	euroloodvrij	BNW:STL:ONV
euroloodvrije	euroloodvrij	BNW:STL:VRB
ex-generaal	ex-generaal	BNW:STL:ONV
ex-militair	ex-militair	BNW:STL:ONV
ex-militairen	ex-militair	BNW:STL:MRV:DE_
ex-personeel	ex-personeel	BNW:STL:ONV
exportras	exportras	BNW:STL:ONV
exportrassen	exportras	BNW:STL:MRV:DE_
familieleed	familieleed	BNW:STL:ONV
familietrouw	familietrouw	BNW:STL:ONV
feestdos	feestdos	ZNW:MRV:DE_
feestlicht	feestlicht	BNW:STL:ONV
feesttips	feesttips	BNW:STL:ONV
fietsstatief	fietsstatief	BNW:STL:ONV
filmcomplex	filmcomplex	BNW:STL:ONV
filtertips	filtertips	BNW:STL:ONV
filtratiedruk	filtratiedruk	BNW:STL:ONV
fitnesstips	fitnesstips	BNW:STL:ONV
fluorzuur	fluorzuur	BNW:STL:ONV
follow-upduur	follow-upduur	BNW:STL:ONV
fransmans	fransmans	BNW:STL:ONV
fraudeleus	fraudeleus	BNW:STL:IET
fraudeleus	fraudeleus	BNW:STL:ONV
fraudeleuze	fraudeleus	BNW:STL:VRB
frontstuk	frontstuk	BNW:STL:ONV
funderingsdruk	funderingsdruk	BNW:STL:ONV
fysicalokaal	fysicalokaal	BNW:STL:ONV
galmstraal	galmstraal	BNW:STL:ONV
geboortedefect	geboortedefect	BNW:STL:ONV
geboortedefecten	geboortedefect	BNW:STL:MRV:DE_
geheimagenten	geheimagent	ZNW:MRV:DE_
geheugendefect	geheugendefect	BNW:STL:ONV
geheugendefecten	geheugendefect	BNW:STL:MRV:DE_
geleidelicht	geleidelicht	BNW:STL:ONV
gelijkbaar	gelijkbaar	BNW:STL:ONV
gelijkbare	gelijkbaar	BNW:STL:VRB
geloofsritueel	geloofsritueel	BNW:STL:ONV
geloofsrituelen	geloofsritueel	BNW:STL:MRV:DE_
geloofsvlak	geloofsvlak	BNW:STL:ONV
geluidbestand	geluidbestand	BNW:STL:ONV
geluidbestanden	geluidbestand	BNW:STL:MRV:DE_
geocachen	geocachen	WKW:INF:ZNW:HET
geregistreerden	registreren	WKW:VTD:MRV:DE_
gesleed	gesleed	ZNW:EKV:HET
gesolveerd	solveren	WKW:VTD:ONV
gesubscribed	subscriben	WKW:VTD:ONV
gevlet	vletten	WKW:VTD:ONV
gevolglijk	gevolglijk	BNW:STL:ONV
gewant	wanten	WKW:VTD:ONV
gildestuk	gildestuk	BNW:STL:ONV
glaskeramiek	glaskeramiek	BNW:STL:ONV
glijdbaar	glijdbaar	BNW:STL:ONV
glucosegebruik	glucosegebruik	BNW:STL:ONV
godallemachtig	godallemachtig	BNW:STL:ONV
goudlicht	goudlicht	BNW:STL:ONV
graafmaterieel	graafmaterieel	BNW:STL:ONV
graaikapitaal	graaikapitaal	BNW:STL:ONV
gratierecht	gratierecht	BNW:STL:ONV
groepstitel	groepstitel	BNW:STL:ONV
groepstitels	groepstitel	BNW:STL:MRV:DE_
grondbaar	grondbaar	BNW:STL:ONV
grondvuil	grondvuil	BNW:STL:ONV
grotelijks	grotelijks	BNW:STL:ONV
half-om-half	half-om-half	BNW:STL:ONV
halsreikend	halsreikend	BNW:STL:ONV
handel	handel	ZNW:EKV
handgereedschap	handgereedschap	ZNW:EKV
hardlooptips	hardlooptips	BNW:STL:ONV
hardsteenlaag	hardsteenlaag	BNW:STL:ONV
hardwaredefect	hardwaredefect	BNW:STL:ONV
hardwaredefecten	hardwaredefect	BNW:STL:MRV:DE_
hechtenisstraf	hechtenisstraf	BNW:STL:ONV
hemelrond	hemelrond	BNW:STL:ONV
hemeltjelief	hemeltjelief	BNW:STL:ONV
herenjas	herenjas	ZNW:MRV:DE_
herfstbries	herfstbries	ZNW:MRV:DE_
herkenbaard	herkenbaard	ZNW:EKV:DE_
hermelijnbont	hermelijnbont	BNW:STL:ONV
hoofdcontent	hoofdcontent	BNW:STL:ONV
hoofdheiligdom	hoofdheiligdom	BNW:STL:ONV
hoogzomer	hoogzomer	ZNW:EKV:DE_
hulpgemaal	hulpgemaal	BNW:STL:ONV
hulprecht	hulprecht	BNW:STL:ONV
hyperlokaal	hyperlokaal	ZNW:EKV
hypermobiel	hypermobiel	ZNW:EKV:DE_
hypotheekleed	hypotheekleed	BNW:STL:ONV
ijdellijk	ijdellijk	BNW:STL:ONV
ijskarren	ijskarren	ZNW:EKV
ijskarren	ijskarren	ZNW:MRV:DE_
ijskarretje	ijskarren	ZNW:EKV:VRK:HET
ijskarretjes	ijskarren	ZNW:MRV:VRK:DE_
impregneerlaag	impregneerlaag	BNW:STL:ONV
incubatieduur	incubatieduur	BNW:STL:ONV
insectendruk	insectendruk	BNW:STL:ONV
intermodaal	intermodaal	ZNW:EKV
internettips	internettips	BNW:STL:ONV
inventarisstuk	inventarisstuk	BNW:STL:ONV
isoleergrond	isoleergrond	BNW:STL:ONV
jagersjas	jagersjas	ZNW:MRV:DE_
jeugdbestand	jeugdbestand	BNW:STL:ONV
jodenkinderen	jodenkind	ZNW:MRV:DE_
jodenkindje	jodenkind	ZNW:EKV:VRK:HET
judojas	judojas	ZNW:MRV:DE_
kaakstomp	kaakstomp	BNW:STL:ONV
kaasrecht	kaasrecht	BNW:STL:ONV
kachelzwart	kachelzwart	BNW:STL:ONV
kampcomplex	kampcomplex	BNW:STL:ONV
kampeertips	kampeertips	BNW:STL:ONV
kapotjas	kapotjas	ZNW:MRV:DE_
karakterfout	karakterfout	BNW:STL:ONV
karakterfouten	karakterfout	BNW:STL:MRV:DE_
karamellaag	karamellaag	BNW:STL:ONV
keldercomplex	keldercomplex	BNW:STL:ONV
keldercomplexen	keldercomplex	BNW:STL:MRV:DE_
keramieklokaal	keramieklokaal	BNW:STL:ONV
kerkpubliek	kerkpubliek	BNW:STL:ONV
kerstbloemstuk	kerstbloemstuk	BNW:STL:ONV
kerstslee	kerstslee	BNW:STL:ONV
kickboxen	kickboxen	WKW:INF:ZNW:HET
kieuwslak	kieuwslak	BNW:STL:ONV
kikkerbillen	kikkerbillen	ZNW:EKV
kikkerbillen	kikkerbillen	ZNW:MRV:DE_
kikkerbilletje	kikkerbillen	ZNW:EKV:VRK:HET
kikkerbilletjes	kikkerbillen	ZNW:MRV:VRK:DE_
kindersanitair	kindersanitair	BNW:STL:ONV
kinderweekend	kinderweekend	BNW:STL:ONV
klanttevreden	klanttevreden	BNW:STL:ONV
klimaattips	klimaattips	BNW:STL:ONV
kloostergrond	kloostergrond	BNW:STL:ONV
knetterdruk	knetterdruk	ZNW:EKV:DE_
knijpdruk	knijpdruk	BNW:STL:ONV
knobbelgans	knobbelgans	BNW:STL:ONV
knobbelganzen	knobbelgans	BNW:STL:MRV:DE_
knotsslak	knotsslak	BNW:STL:ONV
knutsellokaal	knutsellokaal	BNW:STL:ONV
kokosgrond	kokosgrond	BNW:STL:ONV
koloniaals	koloniaals	BNW:STL:ONV
konijnenbontjas	konijnenbontjas	ZNW:MRV:DE_
koningsrijk	koningsrijk	BNW:STL:ONV
korfbalcomplex	korfbalcomplex	BNW:STL:ONV
korrellaag	korrellaag	BNW:STL:ONV
kostenbestand	kostenbestand	BNW:STL:ONV
kostenbestanden	kostenbestand	BNW:STL:MRV:DE_
kraangebruik	kraangebruik	BNW:STL:ONV
krijgbaar	krijgbaar	BNW:STL:ONV
krijgbare	krijgbaar	BNW:STL:VRB
kruidenthees	kruidenthees	BNW:STL:ONV
kruiswijs	kruiswijs	BNW:STL:ONV
kuispersoneel	kuispersoneel	BNW:STL:ONV
kunstgrasstroken	kunstgrasstrook	ZNW:MRV:DE
kunststofstroken	kunststofstrook	ZNW:MRV:DE
kwartaaltarief	kwartaaltarief	BNW:STL:ONV
kwartaaltarieven	kwartaaltarief	BNW:STL:MRV:DE_
kweekduur	kweekduur	BNW:STL:ONV
kwintparallel	kwintparallel	BNW:STL:ONV
kwintparallellen	kwintparallel	BNW:STL:MRV:DE_
laatstvermelde	laatstvermelde	BNW:STL:ONV
labojas	labojas	ZNW:MRV:DE_
laboratoriumjas	laboratoriumjas	ZNW:MRV:DE_
lakjas	lakjas	ZNW:MRV:DE_
lampzwart	lampzwart	BNW:STL:ONV
lapdancen	lapdancen	WKW:INF:ZNW:HET
leidingslokaal	leidingslokaal	BNW:STL:ONV
lekenpersoneel	lekenpersoneel	BNW:STL:ONV
lentebries	lentebries	ZNW:MRV:DE_
lenteritueel	lenteritueel	BNW:STL:ONV
lenterituelen	lenteritueel	BNW:STL:MRV:DE_
levensleed	levensleed	BNW:STL:ONV
levensmoede	levensmoede	BNW:STL:ONV
liefdesleed	liefdesleed	BNW:STL:ONV
liefdesvlak	liefdesvlak	BNW:STL:ONV
lijstbestand	lijstbestand	BNW:STL:ONV
linedancen	linedancen	WKW:INF:ZNW:HET
linkerrijstroken	linkerrijstrook	ZNW:MRV:DE
listiglijk	listiglijk	BNW:STL:ONV
lithiumgebruik	lithiumgebruik	BNW:STL:ONV
lofprijzend	lofprijzend	BNW:STL:ONV
logeertips	logeertips	BNW:STL:ONV
loodsencomplex	loodsencomplex	BNW:STL:ONV
lp	lp	ZNW:EKV
luchtacrobatiek	luchtacrobatiek	BNW:STL:ONV
luisterduur	luisterduur	BNW:STL:ONV
maagbitter	maagbitter	BNW:STL:ONV
machinedefect	machinedefect	BNW:STL:ONV
machinedefecten	machinedefect	BNW:STL:MRV:DE_
machtscomplex	machtscomplex	BNW:STL:ONV
mangatdeksels	mangatdeksels	BNW:STL:ONV
mannentrouw	mannentrouw	BNW:STL:ONV
mannetjesgans	mannetjesgans	BNW:STL:ONV
maskerlaag	maskerlaag	BNW:STL:ONV
massadefect	massadefect	BNW:STL:ONV
materiaaldruk	materiaaldruk	BNW:STL:ONV
matigingsgrond	matigingsgrond	BNW:STL:ONV
maïslaag	maïslaag	BNW:STL:ONV
mediaanvlak	mediaanvlak	BNW:STL:ONV
mediavlak	mediavlak	BNW:STL:ONV
meeben	meezijn	WKW:TGW:1EP
meebent	meezijn	WKW:TGW:3EP
meegeweest	meezijn	WKW:VTD:ONV
meewas	meezijn	WKW:VLT:1EP
meezijn	meezijn	WKW:TGW:INF
melkequivalent	melkequivalent	BNW:STL:ONV
melkweigering	melkweigering	BNW:STL:ONV
mennoniet	mennoniet	BNW:STL:ONV
menselijkerwijs	menselijkerwijs	BNW:STL:ONV
menselijkerwijze	menselijkerwijze	ZNW:EKV:DE_
mentaliseren	mentaliseren	WKW:INF:ZNW:HET
messrooms	messrooms	BNW:STL:ONV
mesttekort	mesttekort	BNW:STL:ONV
mierenzoet	mierenzoet	BNW:STL:ONV
mitochondriaal	mitochondriaal	ZNW:EKV
modderduivels	modderduivels	BNW:STL:ONV
moddergrond	moddergrond	BNW:STL:ONV
moedergans	moedergans	BNW:STL:ONV
moestuingrond	moestuingrond	BNW:STL:ONV
mondjevol	mondjevol	BNW:STL:ONV
motordefect	motordefect	BNW:STL:ONV
motordefecten	motordefect	BNW:STL:MRV:DE_
motorjas	motorjas	ZNW:MRV:DE_
mucuslaag	mucuslaag	BNW:STL:ONV
museumweek	museumweek	BNW:STL:ONV
muziekcontent	muziekcontent	BNW:STL:ONV
muziekrecht	muziekrecht	BNW:STL:ONV
naaldbomentuin	naaldbomentuin	BNW:STL:ONV
natuurideaal	natuurideaal	BNW:STL:ONV
natuurzuiver	natuurzuiver	ZNW:EKV
natuurzuivers	natuurzuiver	ZNW:MRV:DE_
neder	neder	UNSPECIFIED
neppillen	neppillen	ZNW:EKV
neppillen	neppillen	ZNW:MRV:DE_
neppilletje	neppillen	ZNW:EKV:VRK:HET
neppilletjes	neppillen	ZNW:MRV:VRK:DE_
nertsbont	nertsbont	BNW:STL:ONV
nesttrouw	nesttrouw	BNW:STL:ONV
nieuwstips	nieuwstips	BNW:STL:ONV
noordwaards	noordwaards	BNW:STL:ONV
notendruk	notendruk	BNW:STL:ONV
ochtendbries	ochtendbries	ZNW:MRV:DE_
oefenbestand	oefenbestand	BNW:STL:ONV
oefenbestanden	oefenbestand	BNW:STL:MRV:DE_
oeverlicht	oeverlicht	BNW:STL:ONV
ogenzwart	ogenzwart	BNW:STL:ONV
onafgeloste	onafgeloste	BNW:STL:ONV
onafgezien	onafgezien	BNW:STL:ONV
onbedijkte	onbedijkte	BNW:STL:ONV
onbehaarde	onbehaarde	BNW:STL:ONV
onbekeerde	onbekeerde	BNW:STL:ONV
onbekeerden	onbekeerden	BNW:STL:ONV
onbeklemde	onbeklemde	BNW:STL:ONV
onbekostigde	onbekostigde	BNW:STL:ONV
onbeleerde	onbeleerde	BNW:STL:ONV
onberedeneerde	onberedeneerde	BNW:STL:ONV
onbeschilderde	onbeschilderde	BNW:STL:ONV
onbestraalde	onbestraalde	BNW:STL:ONV
onbestudeerde	onbestudeerde	BNW:STL:ONV
onbestuurde	onbestuurde	BNW:STL:ONV
onbevederde	onbevederde	BNW:STL:ONV
onderlaatst	onderlaatst	BNW:STL:ONV
onderwijsgevenden	onderwijsgevend	ZNW:MRV:DE_
ongeadresseerde	ongeadresseerde	BNW:STL:ONV
ongeasfalteerde	ongeasfalteerde	BNW:STL:ONV
ongebalanceerde	ongebalanceerde	BNW:STL:ONV
ongebuikt	ongebuikt	BNW:STL:ONV
ongebuikte	ongebuikt	BNW:STL:VRB
ongecodeerde	ongecodeerde	BNW:STL:ONV
ongecorrigeerde	ongecorrigeerde	BNW:STL:ONV
ongedaanmaking	ongedaanmaking	BNW:STL:ONV
ongedateerde	ongedateerde	BNW:STL:ONV
ongedecoreerde	ongedecoreerde	BNW:STL:ONV
ongediplomeerde	ongediplomeerde	BNW:STL:ONV
ongediplomeerden	ongediplomeerden	BNW:STL:ONV
ongefaseerde	ongefaseerde	BNW:STL:ONV
ongeforceerde	ongeforceerde	BNW:STL:ONV
ongekleurde	ongekleurde	BNW:STL:ONV
ongekoelde	ongekoelde	BNW:STL:ONV
ongekruiste	ongekruiste	BNW:STL:ONV
ongelieerde	ongelieerde	BNW:STL:ONV
ongelijknamige	ongelijknamige	BNW:STL:ONV
ongelukkiglijk	ongelukkiglijk	BNW:STL:ONV
ongemanierde	ongemanierde	BNW:STL:ONV
ongemanipuleerde	ongemanipuleerde	BNW:STL:ONV
ongemarineerde	ongemarineerde	BNW:STL:ONV
ongemarkeerde	ongemarkeerde	BNW:STL:ONV
ongemaskerde	ongemaskerde	BNW:STL:ONV
ongemonteerde	ongemonteerde	BNW:STL:ONV
ongenodigde	ongenodigde	BNW:STL:ONV
ongenormeerde	ongenormeerde	BNW:STL:ONV
ongenummerde	ongenummerde	BNW:STL:ONV
ongeoormerkte	ongeoormerkte	BNW:STL:ONV
ongepaarde	ongepaarde	BNW:STL:ONV
ongepantserde	ongepantserde	BNW:STL:ONV
ongeparfumeerde	ongeparfumeerde	BNW:STL:ONV
ongeposeerde	ongeposeerde	BNW:STL:ONV
ongeprepareerde	ongeprepareerde	BNW:STL:ONV
ongeraffineerde	ongeraffineerde	BNW:STL:ONV
ongerealiseerde	ongerealiseerde	BNW:STL:ONV
ongereguleerde	ongereguleerde	BNW:STL:ONV
ongereinigde	ongereinigde	BNW:STL:ONV
ongerelateerde	ongerelateerde	BNW:STL:ONV
ongesausde	ongesausde	BNW:STL:ONV
ongeschilderde	ongeschilderde	BNW:STL:ONV
ongeschubde	ongeschubde	BNW:STL:ONV
ongesigneerde	ongesigneerde	BNW:STL:ONV
ongesluierde	ongesluierde	BNW:STL:ONV
ongesmeerde	ongesmeerde	BNW:STL:ONV
ongesorteerde	ongesorteerde	BNW:STL:ONV
ongesplitste	ongesplitste	BNW:STL:ONV
ongestoffeerde	ongestoffeerde	BNW:STL:ONV
ongestudeerde	ongestudeerde	BNW:STL:ONV
ongesuikerde	ongesuikerde	BNW:STL:ONV
ongetalenteerde	ongetalenteerde	BNW:STL:ONV
ongetogen	ongetogen	BNW:STL:ONV
ongevaccineerde	ongevaccineerde	BNW:STL:ONV
ongevallig	ongevallig	BNW:STL:ONV
ongevallige	ongevallig	BNW:STL:VRB
ongevaltypen	ongevaltypen	BNW:STL:ONV
ongeveerde	ongeveerde	BNW:STL:ONV
ongevoerde	ongevoerde	BNW:STL:ONV
ongezuiverde	ongezuiverde	BNW:STL:ONV
onkruidgrassen	onkruidgrassen	BNW:STL:ONV
onmeedogenloos	onmeedogenloos	BNW:STL:IET
onmeedogenloos	onmeedogenloos	BNW:STL:ONV
onmeedogenloze	onmeedogenloos	BNW:STL:VRB
onnadenkende	onnadenkende	BNW:STL:ONV
onnadenkenden	onnadenkenden	BNW:STL:ONV
onrespectloos	onrespectloos	BNW:STL:IET
onrespectloos	onrespectloos	BNW:STL:ONV
onrespectloze	onrespectloos	BNW:STL:VRB
onuitgevoerde	onuitgevoerde	BNW:STL:ONV
onverbeterde	onverbeterde	BNW:STL:ONV
onveredelde	onveredelde	BNW:STL:ONV
onverkende	onverkende	BNW:STL:ONV
onversierde	onversierde	BNW:STL:ONV
onversleutelde	onversleutelde	BNW:STL:ONV
onvervaarde	onvervaarde	BNW:STL:ONV
onvervuilde	onvervuilde	BNW:STL:ONV
onverwonnen	onverwonnen	BNW:STL:ONV
onverzekerden	onverzekerden	BNW:STL:ONV
onweershaarden	onweershaarden	BNW:STL:ONV
onzinbiedingen	onzinbiedingen	BNW:STL:ONV
oorlogsnood	oorlogsnood	BNW:STL:ONV
opbergvlak	opbergvlak	BNW:STL:ONV
ophaalnet	ophaalnet	BNW:STL:ONV
opmaaktips	opmaaktips	BNW:STL:ONV
opnameweek	opnameweek	BNW:STL:ONV
oppermatig	oppermatig	BNW:STL:ONV
opstartweek	opstartweek	BNW:STL:ONV
opzeggrond	opzeggrond	BNW:STL:ONV
ouderenweek	ouderenweek	BNW:STL:ONV
overgangsstroken	overgangsstrook	ZNW:MRV:DE
overstaprecht	overstaprecht	BNW:STL:ONV
overwerktarief	overwerktarief	BNW:STL:ONV
overwerktarieven	overwerktarief	BNW:STL:MRV:DE_
paalklimmen	paalklimmen	WKW:TGW:INF
paalwerpen	paalwerpen	WKW:TGW:INF
paardansen	paardansen	WKW:TGW:INF
paardengras	paardengras	BNW:STL:ONV
pakkingvlak	pakkingvlak	BNW:STL:ONV
pallettarief	pallettarief	BNW:STL:ONV
palletten	palletten	WKW:TGW:INF
pandjesjas	pandjesjas	ZNW:MRV:DE_
paperblank	paperblank	BNW:STL:ONV
papierdruk	papierdruk	BNW:STL:ONV
paraffinelaag	paraffinelaag	BNW:STL:ONV
parapenten	parapenten	WKW:TGW:INF
parkeercomplex	parkeercomplex	BNW:STL:ONV
parkpersoneel	parkpersoneel	BNW:STL:ONV
patentenrecht	patentenrecht	BNW:STL:ONV
pentekenen	pentekenen	WKW:TGW:INF
penvissen	penvissen	WKW:TGW:INF
perfusiedruk	perfusiedruk	BNW:STL:ONV
perrongelijk	perrongelijk	BNW:STL:ONV
pianostemmen	pianostemmen	WKW:TGW:INF
pijplassen	pijplassen	WKW:TGW:INF
plantgrond	plantgrond	BNW:STL:ONV
plantsoenstroken	plantsoenstrook	ZNW:MRV:DE
plaquelaag	plaquelaag	BNW:STL:ONV
plasbakken	plasbakken	WKW:TGW:INF
plasticlaag	plasticlaag	BNW:STL:ONV
platenklem	platenklem	BNW:STL:ONV
platjas	platjas	ZNW:MRV:DE_
pleinspelen	pleinspelen	WKW:TGW:INF
pluimwild	pluimwild	BNW:STL:ONV
polijstlaag	polijstlaag	BNW:STL:ONV
politieblauw	politieblauw	BNW:STL:ONV
postmenopauzaal	postmenopauzaal	ZNW:EKV
procesdruk	procesdruk	BNW:STL:ONV
productiegrond	productiegrond	BNW:STL:ONV
proefeten	proefeten	WKW:TGW:INF
proefsporten	proefsporten	WKW:TGW:INF
programmatips	programmatips	BNW:STL:ONV
pruikenbol	pruikenbol	BNW:STL:ONV
puberleed	puberleed	BNW:STL:ONV
pulpeten	pulpeten	WKW:TGW:INF
pulskiezen	pulskiezen	WKW:TGW:INF
pulsvissen	pulsvissen	WKW:TGW:INF
punt	aanpunten	WKW:TGW:1EP:LOS
punt	aanpunten	WKW:TGW:3EP:LOS
puntenlaag	puntenlaag	BNW:STL:ONV
puntte	aanpunten	WKW:VLT:1EP:LOS
puntte	aanpunten	WKW:VLT:INF:LOS
puntte	aanpunten	WKW:TGW:INF:LOS
quasi	quasi	UNSPECIFIED
raamsloten	raamsloten	WKW:TGW:INF
realtime	realtime	UNSPECIFIED
recepissen	recepissen	WKW:TGW:INF
recreatietips	recreatietips	BNW:STL:ONV
referentieel	referentieel	ZNW:EKV
reflectiejas	reflectiejas	ZNW:MRV:DE_
regenboogjas	regenboogjas	ZNW:MRV:DE_
regenstops	regenstops	BNW:STL:ONV
regeringsdruk	regeringsdruk	BNW:STL:ONV
renten	renten	WKW:VLT:INF
reparatietips	reparatietips	BNW:STL:ONV
resectievlak	resectievlak	BNW:STL:ONV
responsduur	responsduur	BNW:STL:ONV
restauranttips	restauranttips	BNW:STL:ONV
retourreizen	retourreizen	WKW:TGW:INF
retraiteweek	retraiteweek	BNW:STL:ONV
rietzeilen	rietzeilen	WKW:TGW:INF
rijpelijk	rijpelijk	BNW:STL:ONV
rinkinkten	rinkinkten	WKW:TGW:INF
roetbruin	roetbruin	BNW:STL:ONV
rokjas	rokjas	ZNW:MRV:DE_
rolski	rolskiën	WKW:TGW:1EP
rompsteunen	rompsteunen	WKW:TGW:INF
rondbekken	rondbekken	WKW:TGW:INF
rondgepast	rondpassen	WKW:VTD:ONV
rondhaken	rondhaken	WKW:TGW:INF
rondpas	rondpassen	WKW:TGW:1EP
rondpast	rondpassen	WKW:TGW:3EP
rondwaard	rondwaard	BNW:STL:ONV
roofvisbestand	roofvisbestand	BNW:STL:ONV
rooklokaal	rooklokaal	BNW:STL:ONV
ropeskippen	ropeskippen	WKW:TGW:INF
rotkreupel	rotkreupel	BNW:STL:ONV
rotorvlak	rotorvlak	BNW:STL:ONV
rouwgebruiken	rouwgebruiken	WKW:TGW:INF
rozemarijnzuur	rozemarijnzuur	BNW:STL:ONV
rustlokaal	rustlokaal	BNW:STL:ONV
salmiakzout	salmiakzout	BNW:STL:ONV
samensprokkelen	samensprokkelen	UNSPECIFIED
sausflessen	sausflessen	WKW:TGW:INF
sausmixen	sausmixen	WKW:TGW:INF
sausspuiten	sausspuiten	WKW:TGW:INF
schaduwvlekken	schaduwvlekken	WKW:TGW:INF
schakelstuk	schakelstuk	BNW:STL:ONV
scharnierstuk	scharnierstuk	BNW:STL:ONV
schedeldefect	schedeldefect	BNW:STL:ONV
schedeldefecten	schedeldefect	BNW:STL:MRV:DE_
scheerlicht	scheerlicht	BNW:STL:ONV
scheerritueel	scheerritueel	BNW:STL:ONV
scheerrituelen	scheerritueel	BNW:STL:MRV:DE_
scheffers	scheffer	ZNW:MRV:DE_
scheffertjes	scheffer	ZNW:MRV:VRK:DE_
schenkritueel	schenkritueel	BNW:STL:ONV
schervengericht	schervengericht	BNW:STL:ONV
schietschouw	schietschouw	BNW:STL:ONV
schijfbestand	schijfbestand	BNW:STL:ONV
schijfbestanden	schijfbestand	BNW:STL:MRV:DE_
schijtziek	schijtziek	ZNW:EKV
schikbarend	schikbarend	BNW:STL:ONV
schilddieren	schilddieren	WKW:TGW:INF
schooleigendom	schooleigendom	BNW:STL:ONV
schooleigendommen	schooleigendom	BNW:STL:MRV:DE_
schoolengels	schoolengels	BNW:STL:ONV
schoonstenen	schoonstenen	WKW:TGW:INF
schorsdelen	schorsdelen	WKW:TGW:INF
schorseneren	schorseneren	WKW:TGW:INF
schouderpunten	schouderpunten	WKW:TGW:INF
schraaplaag	schraaplaag	BNW:STL:ONV
schrijversgraven	schrijversgraven	WKW:TGW:INF
schroefpunten	schroefpunten	WKW:TGW:INF
schuifvlak	schuifvlak	BNW:STL:ONV
schuifzeilen	schuifzeilen	WKW:TGW:INF
schuinrechts	schuinrechts	BNW:STL:ONV
sectorvlak	sectorvlak	BNW:STL:ONV
seizoenbanen	seizoenbanen	WKW:TGW:INF
seksbeesten	seksbeesten	WKW:TGW:INF
seksverhalen	seksverhalen	WKW:TGW:INF
selderijzout	selderijzout	BNW:STL:ONV
semi-intensieve	semi-intensieve	UNSPECIFIED
semi-mobiel	semi-mobiel	BNW:STL:ONV
sensorvlak	sensorvlak	BNW:STL:ONV
septemberweek	septemberweek	BNW:STL:ONV
seriecrimineel	seriecrimineel	BNW:STL:ONV
serregrond	serregrond	BNW:STL:ONV
serverfout	serverfout	BNW:STL:ONV
showstops	showstops	BNW:STL:ONV
shredden	shredden	WKW:VLT:INF
shuttelen	shuttelen	WKW:TGW:INF
sierstrepen	sierstrepen	WKW:TGW:INF
sightseeën	sightseeën	WKW:TGW:INF
silocomplex	silocomplex	BNW:STL:ONV
simultaantolken	simultaantolken	WKW:TGW:INF
situatiegerichte	situatiegerichte	BNW:STL:VRB
sjablonen	sjablonen	WKW:TGW:INF
sjabloondruk	sjabloondruk	BNW:STL:ONV
sjeest	sjezen	WKW:VLT:1EP
skottelbraaien	skottelbraaien	WKW:TGW:INF
slaanbaar	slaanbaar	BNW:STL:ONV
slachtofferjas	slachtofferjas	ZNW:MRV:DE_
slavendood	slavendood	BNW:STL:ONV
slijtagedelen	slijtagedelen	WKW:TGW:INF
slijtagevormen	slijtagevormen	WKW:TGW:INF
slijtdelen	slijtdelen	WKW:TGW:INF
slijtvlak	slijtvlak	BNW:STL:ONV
slipjas	slipjas	ZNW:MRV:DE_
slotritueel	slotritueel	BNW:STL:ONV
sluitdruk	sluitdruk	BNW:STL:ONV
sluitjas	sluitjas	ZNW:MRV:DE_
sluitlicht	sluitlicht	BNW:STL:ONV
smeeroliedruk	smeeroliedruk	BNW:STL:ONV
smoorlijk	smoorlijk	BNW:STL:ONV
smous	smousen	WKW:TGW:1EP
smoust	smousen	WKW:TGW:3EP
sneeuwgans	sneeuwgans	BNW:STL:ONV
sneeuwganzen	sneeuwgans	BNW:STL:MRV:DE_
sneeuwhopen	sneeuwhopen	WKW:TGW:INF
sneldammen	sneldammen	WKW:TGW:INF
snelklemmen	snelklemmen	WKW:TGW:INF
snoekbaar	snoekbaar	BNW:STL:ONV
snoekbaars	snoekbaar	BNW:STL:IET
snoekbaarst	snoekbaar	BNW:OVR:ONV
snorvliegen	snorvliegen	WKW:TGW:INF
snottebellen	snottebellen	WKW:TGW:INF
snuffelweek	snuffelweek	BNW:STL:ONV
solmiseren	solmiseren	WKW:TGW:INF
songboeken	songboeken	WKW:TGW:INF
souteneert	souteneren	WKW:TGW:3EP
spaanvlak	spaanvlak	BNW:STL:ONV
spaarmunten	spaarmunten	WKW:TGW:INF
spamlijsten	spamlijsten	WKW:TGW:INF
spanningsdruk	spanningsdruk	BNW:STL:ONV
speciedruk	speciedruk	BNW:STL:ONV
speeldruk	speeldruk	BNW:STL:ONV
speelmunten	speelmunten	WKW:TGW:INF
spelerijden	spelerijden	WKW:TGW:INF
speltactiek	speltactiek	BNW:STL:ONV
spijtbaar	spijtbaar	BNW:STL:ONV
spitslijnen	spitslijnen	WKW:TGW:INF
springgericht	springgericht	BNW:STL:ONV
springgerichte	springgericht	BNW:STL:VRB
springvlak	springvlak	BNW:STL:ONV
sproeistuk	sproeistuk	BNW:STL:ONV
spuitduur	spuitduur	BNW:STL:ONV
staatstaken	staatstaken	WKW:TGW:INF
stafpunten	stafpunten	WKW:TGW:INF
stafrechtelijk	stafrechtelijk	BNW:STL:ONV
standaardduur	standaardduur	BNW:STL:ONV
standaardreizen	standaardreizen	WKW:TGW:INF
startlaag	startlaag	BNW:STL:ONV
startstuk	startstuk	BNW:STL:ONV
steigerpijpen	steigerpijpen	WKW:TGW:INF
stekblokken	stekblokken	WKW:TGW:INF
stemacrobatiek	stemacrobatiek	BNW:STL:ONV
stembescheiden	stembescheiden	BNW:STL:ONV
stemoproepen	stemoproepen	WKW:TGW:INF
stempelvlak	stempelvlak	BNW:STL:ONV
sterreneten	sterreneten	WKW:TGW:INF
stiergebruik	stiergebruik	BNW:STL:ONV
stieten	stieten	WKW:TGW:INF
stinkpoten	stinkpoten	WKW:TGW:INF
stiptelijk	stiptelijk	BNW:STL:ONV
stoepdelen	stoepdelen	WKW:TGW:INF
stoeptekenen	stoeptekenen	WKW:TGW:INF
stofjas	stofjas	ZNW:MRV:DE_
stofstromen	stofstromen	WKW:TGW:INF
stoomlijnen	stoomlijnen	WKW:TGW:INF
storthopen	storthopen	WKW:TGW:INF
straaldruk	straaldruk	BNW:STL:ONV
strafgerichten	strafgerichten	WKW:TGW:INF
strategoën	strategoën	WKW:TGW:INF
streefdruk	streefdruk	BNW:STL:ONV
streetdancen	streetdancen	WKW:TGW:INF
strengelijk	strengelijk	BNW:STL:ONV
stressverhogende	stressverhogende	BNW:STL:VRB
striduleren	striduleren	WKW:TGW:INF
striptekenen	striptekenen	WKW:TGW:INF
stronteigenwijs	stronteigenwijs	ZNW:EKV:DE_
struikenlaag	struikenlaag	BNW:STL:ONV
studiedelen	studiedelen	WKW:TGW:INF
stukprikken	stukprikken	WKW:TGW:INF
stuwzakken	stuwzakken	WKW:TGW:INF
subscribe	subscriben	WKW:TGW:1EP
subscribe	subscriben	WKW:AWS
subscribede	subscriben	WKW:VLT:1EP
subscriben	subscriben	WKW:TGW:INF
suggestiestroken	suggestiestrook	ZNW:MRV:DE
summerschools	summerschools	BNW:STL:ONV
summierlijk	summierlijk	BNW:STL:ONV
supershot	supershot	BNW:STL:ONV
superstreng	superstreng	ZNW:EKV:DE_
superstrengen	superstreng	ZNW:MRV:DE_
superzwaar	superzwaar	ZNW:EKV
supportersrellen	supportersrellen	WKW:TGW:INF
surinamiseren	surinamiseren	WKW:TGW:INF
systeemdefect	systeemdefect	BNW:STL:ONV
systeemdefecten	systeemdefect	BNW:STL:MRV:DE_
taalacrobatiek	taalacrobatiek	BNW:STL:ONV
taaldrukken	taaldrukken	WKW:TGW:INF
taaloffensief	taaloffensief	BNW:STL:ONV
tafelvlak	tafelvlak	BNW:STL:ONV
taperen	taperen	WKW:TGW:INF
tappelen	tappel	ZNW:MRV:DE_
tar	tar	UNSPECIFIED
teamtotaal	teamtotaal	BNW:STL:ONV
tegelmatig	tegelmatig	BNW:STL:ONV
tegelvlak	tegelvlak	BNW:STL:ONV
tegenvoets	tegenvoets	BNW:STL:IET
tegenvoets	tegenvoets	BNW:STL:ONV
telefoontolken	telefoontolken	WKW:TGW:INF
telegraafgeheim	telegraafgeheim	BNW:STL:ONV
televisiestuk	televisiestuk	BNW:STL:ONV
telewinkelen	telewinkelen	WKW:TGW:INF
teloorgaat	teloorgaat	BNW:STL:ONV
terneer	terneer	UNSPECIFIED
terugbekomen	terugbekomen	ZNW:EKV
teweeg	teweeg	UNSPECIFIED
textielpunten	textielpunten	WKW:TGW:INF
thaiboksen	thaiboksen	WKW:TGW:INF
theatervlak	theatervlak	BNW:STL:ONV
theeboeren	theeboeren	WKW:TGW:INF
thuisbevallende	thuisbevallende	ZNW:EKV:DE_
thuistaps	thuistaps	BNW:STL:ONV
tijdschrijven	tijdschrijven	WKW:TGW:INF
tijdsparadox	tijdsparadox	BNW:STL:ONV
tijgerspinnen	tijgerspinnen	WKW:TGW:INF
toebedelde	toebedelen	WKW:VLT:1EP
toegestoten	toestoten	WKW:VTD:ONV
toegewassen	toegewassen	WKW:TGW:INF
toestoot	toestoten	WKW:TGW:1EP
toestoot	toestoten	WKW:TGW:3EP
toestotende	toestoten	WKW:ODW:VRB
toevloei	toevloei	ZNW:EKV:HET
tongbranden	tongbranden	WKW:TGW:INF
tongpersen	tongpersen	WKW:TGW:INF
tongvaren	tongvaren	WKW:TGW:INF
toongevend	toongevend	BNW:STL:ONV
toongevende	toongevend	BNW:STL:VRB
toonkiezen	toonkiezen	WKW:TGW:INF
topcoaten	topcoaten	WKW:TGW:INF
topictitel	topictitel	BNW:STL:ONV
touwhaken	touwhaken	WKW:TGW:INF
tracen	tracen	WKW:TGW:INF
trainerstips	trainerstips	BNW:STL:ONV
trainingsstroken	trainingsstrook	ZNW:MRV:DE
traktatietips	traktatietips	BNW:STL:ONV
transitiestuk	transitiestuk	BNW:STL:ONV
triktrakken	triktrakken	WKW:TGW:INF
trilspinnen	trilspinnen	WKW:TGW:INF
trimlijnen	trimlijnen	WKW:TGW:INF
troosteten	troosteten	WKW:TGW:INF
trouwbaar	trouwbaar	BNW:STL:ONV
trouwbaarder	trouwbaar	BNW:VGR:ONV
trouwbare	trouwbaar	BNW:STL:VRB
trouwjas	trouwjas	ZNW:MRV:DE_
truckstar	truckstar	BNW:STL:ONV
tuinrubriek	tuinrubriek	BNW:STL:ONV
tuinverhaal	tuinverhaal	BNW:STL:ONV
tuinvriend	tuinvriend	BNW:STL:ONV
turfgraven	turfgraven	WKW:TGW:INF
turnringen	turnringen	WKW:TGW:INF
turnzakken	turnzakken	WKW:TGW:INF
tweeweg	tweeweg	ZNW:EKV:DE_
tweewegen	tweeweg	ZNW:MRV:DE_
uitgereed	uitgereed	BNW:STL:ONV
uitgestekt	uitstekken	WKW:VTD:ONV
uitgestekte	uitstekken	WKW:VTD:VRB
uithieuwen	uithieuwen	WKW:TGW:INF
uitstek	uitstekken	WKW:TGW:1EP
uitstekken	uitstekken	WKW:TGW:INF
uitstekt	uitstekken	WKW:TGW:3EP
uitvalduur	uitvalduur	BNW:STL:ONV
unsubscribe	unsubscriben	WKW:TGW:1EP
unsubscribe	unsubscriben	WKW:AWS
unsubscriben	unsubscriben	WKW:TGW:INF
unsubscribet	unsubscriben	WKW:TGW:3EP
upsellen	upsellen	WKW:TGW:INF
vaaggronden	vaaggronden	WKW:TGW:INF
vaaspoten	vaaspoten	WKW:TGW:INF
vaatzieken	vaatzieken	WKW:TGW:INF
vakantieleed	vakantieleed	BNW:STL:ONV
valeriaanzuur	valeriaanzuur	BNW:STL:ONV
vastdagen	vastdagen	WKW:TGW:INF
vastelijk	vastelijk	BNW:STL:ONV
vastgesp	vastgesp	ZNW:EKV:DE_
vastketen	vastketen	ZNW:EKV:DE_
vastklik	vastklik	ZNW:EKV:DE_
veemgericht	veemgericht	BNW:STL:ONV
veenstroken	veenstroken	WKW:TGW:INF
veenwegen	veenwegen	WKW:TGW:INF
veerresten	veerresten	WKW:TGW:INF
veldbussen	veldbussen	WKW:TGW:INF
veldplaatsen	veldplaatsen	WKW:TGW:INF
verbouwtips	verbouwtips	BNW:STL:ONV
verdeemoedigend	verdeemoedigen	WKW:ODW:ONV
verdeemoedigt	verdeemoedigen	WKW:TGW:3EP
verjeugdigt	verjeugdigen	WKW:TGW:3EP
vermiljoenen	vermiljoen	ZNW:MRV:DE_
verzendduur	verzendduur	BNW:STL:ONV
vestbrieven	vestbrieven	WKW:TGW:INF
vierbaans	vierbaans	BNW:STL:ONV
villatuinen	villatuinen	WKW:TGW:INF
vingerhaken	vingerhaken	WKW:TGW:INF
vingerveeg	vingerveeg	BNW:STL:ONV
vinyllaag	vinyllaag	BNW:STL:ONV
visscholen	visscholen	WKW:TGW:INF
vissersleed	vissersleed	BNW:STL:ONV
visumduur	visumduur	BNW:STL:ONV
vlagseinen	vlagseinen	WKW:TGW:INF
vlakgraven	vlakgraven	WKW:TGW:INF
vlamspuiten	vlamspuiten	WKW:TGW:INF
vlasbollen	vlasbollen	WKW:TGW:INF
vleeseten	vleeseten	WKW:TGW:INF
vlekkentips	vlekkentips	BNW:STL:ONV
vlet	vletten	WKW:TGW:1EP
vlet	vletten	WKW:TGW:3EP
vletten	vletten	WKW:VLT:INF
vletten	vletten	WKW:TGW:INF
vliegtips	vliegtips	BNW:STL:ONV
voerresten	voerresten	WKW:TGW:INF
voetbaltips	voetbaltips	BNW:STL:ONV
voettitel	voettitel	BNW:STL:ONV
voettitels	voettitel	BNW:STL:MRV:DE_
voodoopraktijken	voodoopraktijken	WKW:TGW:INF
voorbeeldstuk	voorbeeldstuk	BNW:STL:ONV
voorgeschreden	voorschrijden	WKW:VTD:ONV
voorjaarsbries	voorjaarsbries	ZNW:MRV:DE_
voorjaarsjas	voorjaarsjas	ZNW:MRV:DE_
voorkóming	voorkóming	ZNW:EKV
voorrij	voorrij	ZNW:EKV:DE_
voorschrijden	voorschrijden	WKW:TGW:INF
voorschrijdend	voorschrijden	WKW:ODW:ONV
voorschrijdende	voorschrijden	WKW:ODW:VRB
voorschrijdt	voorschrijden	WKW:TGW:3EP
voorsla	voorslaan	WKW:AWS
voortent	voortenten	WKW:TGW:1EP
voortent	voortenten	WKW:TGW:3EP
voortenten	voortenten	WKW:TGW:INF
voorwielklem	voorwielklem	BNW:STL:ONV
voorwind	voorwinden	WKW:TGW:1EP
voorwinden	voorwinden	WKW:TGW:INF
vormsporen	vormsporen	WKW:TGW:INF
vorstlaag	vorstlaag	BNW:STL:ONV
vrijgezwommen	vrijzwemmen	WKW:VTD:ONV
vrijschaatsen	vrijschaatsen	WKW:TGW:INF
vrijstralen	vrijstralen	WKW:TGW:INF
vrijuitgaan	vrijuitgaan	WKW:TGW:INF
vrijvliegen	vrijvliegen	WKW:TGW:INF
vrijvragen	vrijvragen	WKW:TGW:INF
vrouwenleed	vrouwenleed	BNW:STL:ONV
vrouwenweek	vrouwenweek	BNW:STL:ONV
vruchtdood	vruchtdood	BNW:STL:ONV
vuildelen	vuildelen	WKW:TGW:INF
vuilresten	vuilresten	WKW:TGW:INF
vulkaanzwart	vulkaanzwart	BNW:STL:ONV
vuurkruiden	vuurkruiden	WKW:TGW:INF
vuurlopen	vuurlopen	WKW:TGW:INF
vuurspuwen	vuurspuwen	WKW:TGW:INF
waardedruk	waardedruk	BNW:STL:ONV
wachtleed	wachtleed	BNW:STL:ONV
wadlopen	wadloop	ZNW:MRV:DE_
wandlicht	wandlicht	BNW:STL:ONV
wandlichten	wandlichten	WKW:TGW:INF
wandwerken	wandwerken	WKW:TGW:INF
want	wanten	WKW:TGW:1EP
wanten	wanten	WKW:TGW:INF
wantte	wanten	WKW:VLT:1EP
wapeningsstroken	wapeningsstrook	ZNW:MRV:DE
wapenruim	wapenruim	BNW:STL:ONV
waterbries	waterbries	ZNW:MRV:DE_
watertips	watertips	BNW:STL:ONV
waxjas	waxjas	ZNW:MRV:DE_
webcasten	webcasten	WKW:TGW:INF
webshoppen	webshoppen	WKW:TGW:INF
webwinkelrecht	webwinkelrecht	BNW:STL:ONV
wederverbonden	wederverbinden	WKW:VLT:INF
wederverbonden	wederverbinden	WKW:VTD:ONV
weefseldefect	weefseldefect	BNW:STL:ONV
weefseldefecten	weefseldefect	BNW:STL:MRV:DE_
weefseldruk	weefseldruk	BNW:STL:ONV
weegpunten	weegpunten	WKW:TGW:INF
weekendtips	weekendtips	BNW:STL:ONV
weekkoersen	weekkoersen	WKW:TGW:INF
weergaveduur	weergaveduur	BNW:STL:ONV
weerszij	weerszij	ZNW:EKV:DE_
weerszijdes	weerszijde	ZNW:MRV:DE_
wegdeklaag	wegdeklaag	BNW:STL:ONV
weggekant	wegkanten	WKW:VTD:ONV
wegkant	wegkanten	WKW:TGW:1EP
wegkanten	wegkanten	WKW:TGW:INF
wegwielrennen	wegwielrennen	WKW:TGW:INF
welgeslaagd	welslagen	WKW:VTD:ONV
welgeslaagde	welslagen	WKW:VTD:VRB
welslagen	welslagen	ZNW:MRV:DE_
welslagen	welslagen	WKW:TGW:INF
wenkkrabben	wenkkrabben	WKW:TGW:INF
werelddansen	werelddansen	WKW:TGW:INF
wereldspits	wereldspits	BNW:STL:ONV
wereldweek	wereldweek	BNW:STL:ONV
werkjas	werkjas	ZNW:MRV:DE_
werkuniform	werkuniform	BNW:STL:ONV
wieldeksels	wieldeksels	BNW:STL:ONV
wielremcilinder	wielremcilinder	BNW:STL:ONV
wijkkaarten	wijkkaarten	WKW:TGW:INF
wildbreien	wildbreien	WKW:TGW:INF
winddelen	winddelen	WKW:TGW:INF
windowshoppen	windowshoppen	WKW:TGW:INF
winkelgebruik	winkelgebruik	BNW:STL:ONV
winkeltips	winkeltips	BNW:STL:ONV
winnares	winnares	ZNW:EKV
winterbries	winterbries	ZNW:MRV:DE_
wisseldelen	wisseldelen	WKW:TGW:INF
wo-studenten	wo-studenten	WKW:TGW:INF
wolvenjong	wolvenjong	BNW:STL:ONV
wonderpillen	wonderpillen	ZNW:EKV
wonderpillen	wonderpillen	ZNW:MRV:DE_
wonderpilletje	wonderpillen	ZNW:EKV:VRK:HET
wonderpilletjes	wonderpillen	ZNW:MRV:VRK:DE_
woningdelen	woningdelen	WKW:TGW:INF
woningsnood	woningsnood	BNW:STL:ONV
woonwaren	woonwaren	WKW:TGW:INF
workshopweek	workshopweek	BNW:STL:ONV
wrakvissen	wrakvissen	WKW:TGW:INF
zaagresten	zaagresten	WKW:TGW:INF
zaaldelen	zaaldelen	WKW:TGW:INF
zadelstuk	zadelstuk	BNW:STL:ONV
zalmvissen	zalmvissen	WKW:TGW:INF
zandschilderen	zandschilderen	WKW:TGW:INF
zanglokaal	zanglokaal	BNW:STL:ONV
zangweken	zangweken	WKW:TGW:INF
zeeframen	zeeframen	WKW:TGW:INF
zeepstoffen	zeepstoffen	WKW:TGW:INF
zeiljassen	zeiljassen	WKW:TGW:INF
zeilschouw	zeilschouw	BNW:STL:ONV
zoekplaats	zoekplaatsen	WKW:TGW:1EP
zoekplaatsen	zoekplaatsen	WKW:TGW:INF
zoekprenten	zoekprenten	WKW:TGW:INF
zoekuren	zoekuren	WKW:TGW:INF
zoekwensen	zoekwensen	WKW:TGW:INF
zomerbries	zomerbries	ZNW:MRV:DE_
zomerleed	zomerleed	BNW:STL:ONV
zonnebloempasta	zonnebloempasta	ZNW:EKV
zonnekloppen	zonnekloppen	WKW:TGW:INF
zoogenten	zoogenten	WKW:TGW:INF
zorgcollectief	zorgcollectief	BNW:STL:ONV
zorgdagen	zorgdagen	WKW:TGW:INF
zorgdoelen	zorgdoelen	WKW:TGW:INF
zorglokaal	zorglokaal	BNW:STL:ONV
zoutkathedraal	zoutkathedraal	BNW:STL:ONV
zoutstengels	zoutstengels	BNW:STL:ONV
zuipschuren	zuipschuren	WKW:TGW:INF
zwansen	zwansen	WKW:TGW:INF
zwart-op-wit	zwart-op-wit	BNW:STL:ONV
zwart-op-witte	zwart-op-wit	BNW:STL:VRB
zwartjassen	zwartjassen	WKW:TGW:INF
zwartkrassen	zwartkrassen	WKW:TGW:INF
zwembrillen	zwembrillen	ZNW:EKV
zwembrillen	zwembrillen	ZNW:MRV:DE_
zwembrilletje	zwembrillen	ZNW:EKV:VRK:HET
zwembrilletjes	zwembrillen	ZNW:MRV:VRK:DE_
álles	álles	ZNW:EKV
aanrijdbelastingen	aanrijdbelasting	ZNW:MRV:DE_
hypermobielen	hypermobiel	ZNW:MRV:DE_
weerszijden	weerszij	ZNW:MRV:DE_
achteraanlopenden	achteraanlopen	WKW:ODW:MRV:DE_
welslagenden	welslagen	WKW:ODW:MRV:DE_
hoogzomers	hoogzomer	ZNW:MRV:DE_
hoogzomertje	hoogzomer	ZNW:EKV:VRK:HET
overtrouw	overtrouw	BNW:STL:ONV
pruikenbollen	pruikenbol	BNW:STL:MRV:DE_
schietschouwen	schietschouw	BNW:STL:MRV:DE_
aanstelbaren	aanstelbaar	ZNW:MRV:DE_
patentenrechten	patentenrecht	BNW:STL:MRV:DE_
sanctieplaatsen	sanctieplaatsen	WKW:TGW:INF
medeontwikkelen	medeontwikkelen	WKW:INF:ZNW:HET
rondlicht	rondlicht	BNW:STL:ONV
schrikbaren	schrikbaar	ZNW:MRV:DE_
smeltpotten	smeltpotten	WKW:TGW:INF
schuifgolven	schuifgolven	WKW:TGW:INF
stapelzetten	stapelzetten	WKW:TGW:INF
schijngrenzen	schijngrenzen	WKW:TGW:INF
vonniswijzen	vonniswijzen	WKW:TGW:INF
snuffellessen	snuffellessen	WKW:TGW:INF
strafbevelen	strafbevelen	WKW:TGW:INF
structuurstroken	structuurstrook	ZNW:MRV:DE
vaartdagen	vaartdagen	WKW:TGW:INF
stage-eisen	stage-eisen	WKW:TGW:INF
vectortekenen	vectortekenen	WKW:TGW:INF
doorzichtstroken	doorzichtstrook	ZNW:MRV:DE
sponsormerken	sponsormerken	WKW:TGW:INF
treinwegen	treinwegen	WKW:TGW:INF
burgerschouwen	burgerschouw	BNW:STL:MRV:DE_
reclamevoeren	reclamevoeren	WKW:TGW:INF
zwaardlopen	zwaardlopen	WKW:TGW:INF
wattenrollen	wattenrollen	WKW:TGW:INF
stalenpennen	stalenpennen	WKW:TGW:INF
roedelopen	roedelopen	WKW:TGW:INF
schimmelsporten	schimmelsporten	WKW:TGW:INF
planklopen	planklopen	WKW:TGW:INF
vogelpotten	vogelpotten	WKW:TGW:INF
schijnblokken	schijnblokken	WKW:TGW:INF
modeleisen	mode	ZNW:MRV:DE_
steeldelen	steeldelen	WKW:TGW:INF
schelpenvissen	schelpenvissen	WKW:TGW:INF
vraagtalen	vraagtalen	WKW:TGW:INF
schrijfstraffen	schrijfstraffen	WKW:TGW:INF
spoelhuizen	spoelhuizen	WKW:TGW:INF
vibratielassen	vibratielassen	WKW:TGW:INF
coderingsstroken	coderingsstrook	ZNW:MRV:DE
zwaailappen	zwaailappen	WKW:TGW:INF
strooibommen	strooibommen	WKW:TGW:INF
selectiegidsen	selectiegidsen	WKW:TGW:INF
startlessen	startlessen	WKW:TGW:INF
survivaldagen	survivaldagen	WKW:TGW:INF
reparatiestroken	reparatiestrook	ZNW:MRV:DE
overarticuleren	overarticuleren	WKW:INF:ZNW:HET
medeontwikkeld	medeontwikkeld	BNW:STL:ONV
uitvoortvloeien	uitvoortvloeien	UNSPECIFIED
wegsodemieteren	wegsodemieteren	UNSPECIFIED
overbevoorraden	overbevoorraden	WKW:INF:ZNW:HET
terugbegeleiden	terugbegeleiden	UNSPECIFIED
voorafspiegelen	voorafspiegelen	UNSPECIFIED
voorbestempelen	voorbestempelen	UNSPECIFIED
voorbijscrollen	voorbijscrollen	UNSPECIFIED
eendelijken	eendelijk	BNW:STL:MRV:DE_
mennonieten	mennoniet	BNW:STL:MRV:DE_
bijbelgetrouwste	bijbelgetrouw	BNW:OVR:VRB
teleur	teleur	UNSPECIFIED
Heineken	Heineken	ENM:LOC:PTS
Jodenvervolging	Jodenvervolging	ENM:LOC:PTS
Zuiderzeepolder	Zuiderzeepolder	UNSPECIFIED
Jodenvervolgingen	Jodenvervolgingen	ZNW:MRV:DE_
Zuiderzeepolders	Zuiderzeepolders	UNSPECIFIED
WvS	WvS	UNSPECIFIED
welgeslaagden	welslagen	WKW:VTD:ZNW:MRV:DE_
punten	aanpunten	WKW:TGW:INF:LOS
waar	rondwaren	WKW:TGW:1EP:LOS
waarde	rondwaren	WKW:VLT:1EP:LOS
waarden	rondwaren	WKW:VLT:INF:LOS
waart	rondwaren	WKW:TGW:3EP:LOS
waren	rondwaren	WKW:TGW:INF:LOS
toelonkend	toelonken	WKW:ODW:ONV
toelonkende	toelonken	WKW:ODW:VRB
toelonkt	toelonken	WKW:TGW:3EP
uitgehieuwd	uithieuwen	WKW:VTD:ONV
uithieuw	uithieuwen	WKW:TGW:1EP
weerkant	weerkant	ZNW:EKV
wezen	wegwezen	WKW:TGW:INF:LOS
eigen	toe-eigenen	WKW:VLT:1EP:LOS
vooruitgeziene	vooruitzien	WKW:VTD:ZNW:EKV
stof	afstoffen	WKW:TGW:1EP:LOS
stoffen	afstoffen	WKW:TGW:INF:LOS
gestoft	afstoffen	WKW:VLT:1EP:LOS
stoften	afstoffen	WKW:VLT:INF:LOS
vergastte	vergasten	WKW:VTD:VRB
vergastten	vergasten	WKW:VTD:ZNW:MRV:DE_
pootjebaadde	pootjebaden	WKW:VLT:1EP
pootjebaadt	pootjebaden	WKW:TGW:3EP
zittenblijven	zittenblijven	WKW:TGW:INF
spuitgieten	spuitgieten	WKW:TGW:INF
videobellen	videobellen	WKW:TGW:INF
prijsschieten	prijsschieten	WKW:TGW:INF
salsadansen	salsadansen	WKW:TGW:INF
sumoworstelen	sumoworstelen	WKW:TGW:INF
natscheren	natscheren	WKW:TGW:INF
natscherende	natscheren	WKW:ODW:VRB
voipen	voipen	WKW:TGW:INF
voip	voipen	WKW:TGW:1EP
skif	skiffen	WKW:TGW:1EP
zorgsparen	zorgsparen	WKW:TGW:INF
zoetvijlen	zoetvijlen	WKW:TGW:INF
zoetvijl	zoetvijlen	WKW:TGW:1EP
wildwaterkanoën	wildwaterkanoën	WKW:TGW:INF
dubbelzien	dubbelzien	WKW:INF:ZNW:HET
aanrijdkosten	aanrijdkosten	ZNW:MRV:DE_
pensioensparen	pensioensparen	WKW:TGW:INF
portrettekenen	portrettekenen	WKW:TGW:INF
slapengaan	slapengaan	WKW:TGW:INF
snellezen	snellezen	WKW:TGW:INF
snellezende	snellezen	WKW:ODW:VRB
snelschaken	snelschaken	WKW:TGW:INF
snelschakend	snelschaken	WKW:ODW:ONV
sportklimmen	sportklimmen	WKW:TGW:INF
strandjuttende	strandjutten	WKW:ODW:VRB
tegelzetten	tegelzetten	WKW:TGW:INF
trappenlopen	trappenlopen	WKW:TGW:INF
turfsteken	turfsteken	WKW:TGW:INF
turfstekende	turfsteken	WKW:ODW:VRB
veldrijden	veldrijden	WKW:TGW:INF
vogelschieten	vogelschieten	WKW:TGW:INF
voorgehangenen	voorhangen	WKW:VTD:ZNW:MRV:DE_
wildplakken	wildplakken	WKW:TGW:INF
onbegravene	onbegraven	BNW:STL:VRB
straatrace	straatracen	WKW:TGW:1EP
gestraatracet	straatracen	WKW:VTD:ONV
straatvegen	straatvegen	WKW:TGW:INF
touwklimmen	touwklimmen	WKW:TGW:INF
touwklimmend	touwklimmen	WKW:ODW:ONV
ongeschapene	ongeschapen	BNW:STL:VRB
slagturven	slagturven	WKW:TGW:INF
ziekzoeken	ziekzoeken	WKW:TGW:INF
aagjes	aagjes	ZNW:MRV:VRK:DE_
sublicentiëren	sublicentiëren	WKW:TGW:INF
gesublicentieerd	sublicentiëren	WKW:VTD:ONV
topcoat	topcoaten	WKW:TGW:1EP
topcoat	topcoaten	WKW:TGW:3EP
zwartvissen	zwartvissen	WKW:TGW:INF
zwartvis	zwartvissen	WKW:TGW:1EP
golfsurfen	golfsurfen	WKW:INF:ZNW:HET
strandzeilen	strandzeilen	WKW:TGW:INF
wrakduiken	wrakduiken	WKW:TGW:INF
dropshotten	dropshotten	WKW:INF:ZNW:HET
stoelenmatten	stoelenmatten	WKW:TGW:INF
terreinrijden	terreinrijden	WKW:TGW:INF
gelachtige	gelachtige	BNW:STL:ONV
auralezen	auralezen	WKW:INF:ZNW:HET
ultrakleine	ultrakleine	BNW:STL:ONV
triviant	trivianten	WKW:TGW:1EP
bakra	bakra	ZNW:EKV:DE_
gerede	reden	WKW:VTD:ONV
zwolg	zwelgen	WKW:VLT:INF
snerken	snerken	WKW:TGW:INF
rundergehaktbal	rundergehaktbal	ZNW:EKV
blikogen	blikogen	WKW:TGW:INF
blikoog	blikogen	WKW:TGW:1EP
bumperen	bumperen	WKW:INF:ZNW:HET
talie	taliën	WKW:TGW:1EP
taliet	taliën	WKW:TGW:3EP
rotsklimmen	rotsklimmen	WKW:TGW:INF
praktijkleren	praktijkleren	WKW:TGW:INF
schapendrijven	schapendrijven	WKW:TGW:INF
gekogellagerd	gekogellagerd	BNW:STL:ONV
snelladen	snelladen	WKW:TGW:INF
patroontekenen	patroontekenen	WKW:TGW:INF
spijkerpoepen	spijkerpoepen	WKW:TGW:INF
schatgraven	schatgraven	WKW:TGW:INF
tekeer	tekeergaan	UNSPECIFIED
piepschuimbal	piepschuimbal	ZNW:EKV
vaarde	vaarde	WKW:VLT:1EP
vaarden	vaarden	WKW:VLT:INF
baanarchitect	baanarchitect	ZNW:EKV
chocoladeblok	chocoladeblok	ZNW:EKV
schijfremblok	schijfremblok	ZNW:EKV
achterremklauw	achterremklauw	ZNW:EKV
huidparasiet	huidparasiet	ZNW:EKV
ongevalspatiënt	ongevalspatiënt	ZNW:EKV
handprothese	handprothese	ZNW:EKV
trekgewicht	trekgewicht	ZNW:EKV
netwerkaanval	netwerkaanval	ZNW:EKV
schildersvriend	schildersvriend	ZNW:EKV
tuinvriend	tuinvriend	ZNW:EKV
ademgeluid	ademgeluid	ZNW:EKV
aardscheur	aardscheur	ZNW:EKV
bekledingstof	bekledingstof	ZNW:EKV
belspel	belspel	ZNW:EKV
bedrijfsreis	bedrijfsreis	ZNW:EKV
duinrel	duinrel	ZNW:EKV
beenriem	beenriem	ZNW:EKV
bijtrol	bijtrol	ZNW:EKV
verenstaal	verenstaal	ZNW:EKV
folkdans	folkdans	ZNW:EKV
beunbak	beunbak	ZNW:EKV
databerg	databerg	ZNW:EKV
bergingsdeur	bergingsdeur	ZNW:EKV
afstandsdier	afstandsdier	ZNW:EKV
bloemdijk	bloemdijk	ZNW:EKV
bewegingsdoel	bewegingsdoel	ZNW:EKV
aardhond	aardhond	ZNW:EKV
boerderijhond	boerderijhond	ZNW:EKV
fasefout	fasefout	ZNW:EKV
snijgas	snijgas	ZNW:EKV
stikgas	stikgas	ZNW:EKV
landgoede	landgoede	ZNW:EKV
banenkans	banenkans	ZNW:EKV
bietenhoop	bietenhoop	ZNW:EKV
onderwijsgevend	onderwijsgevend	ZNW:EKV
blokhaag	blokhaag	ZNW:EKV
boomrij	boomrij	ZNW:EKV
attractiepool	attractiepool	ZNW:EKV
opberglade	opberglade	ZNW:EKV
beheersdaad	beheersdaad	ZNW:EKV
handbad	handbad	ZNW:EKV
flexbaan	flexbaan	ZNW:EKV
aanstelbaar	aanstelbaar	ZNW:EKV
schrikbaar	schrikbaar	ZNW:EKV
staaltype	staaltype	ZNW:EKV
vetot	vetoën	WKW:TGW:3EP
reven	binnenrijven	WKW:VLT:1EP:LOS
teambuild	teambuilden	WKW:TGW:1EP
radiobestuurde	radiobestuurde	BNW:STL:ONV
videoklem	videoklem	BNW:STL:ONV
bruinkoollaag	bruinkoollaag	BNW:STL:ONV
triktrak	triktrakken	WKW:TGW:1EP
triktrakkende	triktrakken	WKW:ODW:VRB
deux-piècesje	deux-pièces	ZNW:EKV:VRK:HET
achterwaarde	achterwaren	WKW:VLT:1EP
achterwaard	achterwaren	WKW:VTD:ONV
achterwaart	achterwaren	WKW:TGW:3EP
achterwaarden	achterwaren	WKW:VLT:INF
achterwaarde	achterwaren	WKW:VTD:VRB
achterwaarden	achterwaren	WKW:VTD:ZNW:MRV:DE_
gesnuit	snuiten	WKW:VTD:ONV
snuite	snuiten	WKW:AWS
verlei	verleien	WKW:TGW:1EP
verleide	verleien	WKW:VLT:1EP
verleiden	verleien	WKW:VLT:INF
rande	afranden	WKW:AWS:LOS
uitsliep	uitsliepen	WKW:TGW:1EP
uitgesliept	uitsliepen	WKW:VTD:ONV
uitsliept	uitsliepen	WKW:TGW:3EP
sliepen	uitsliepen	WKW:TGW:INF:LOS
sliep	uitsliepen	WKW:TGW:1EP:LOS
sliept	uitsliepen	WKW:TGW:3EP:LOS
sliepe	uitsliepen	WKW:AWS:LOS
vraagde	vragen	WKW:VLT:1EP
vraagden	vragen	WKW:VLT:INF
spotlach	spotlachen	WKW:TGW:1EP
spotlacht	spotlachen	WKW:TGW:3EP
uitgezweerd	uitzweren	WKW:VTD:ONV
weeromkom	weeromkomen	WKW:TGW:1EP
weeromkomend	weeromkomen	WKW:ODW:ONV
weeromkomt	weeromkomen	WKW:TGW:3EP
afgetruggeld	aftruggelen	WKW:VTD:ONV
aftruggelt	aftruggelen	WKW:TGW:3EP
gegradueerde	gegradueerd	BNW:STL:ONV
schaarden	schaarden	WKW:TGW:INF
stratego	strategoën	WKW:TGW:1EP
strategode	strategoën	WKW:VLT:1EP
gestrategood	strategoën	WKW:VTD:ONV
vergrofd	vergroven	WKW:VTD:ONV
spolieerde	spoliëren	WKW:VLT:1EP
gespolieerd	spoliëren	WKW:VTD:ONV
gespolieerde	spoliëren	WKW:VTD:VRB
spelerijdend	spelerijden	WKW:ODW:ONV
trendsetten	trendsetten	WKW:VLT:INF
wegis	wegwezen	WKW:TGW:1EP
sleepvoeten	sleepvoeten	WKW:TGW:INF
sleepvoet	sleepvoeten	WKW:TGW:1EP
sleepvoet	sleepvoeten	WKW:TGW:3EP
streetdance	streetdancen	WKW:TGW:1EP
streetdance	streetdancen	WKW:AWS
veemgerichten	veemgericht	BNW:STL:MRV:DE_
sightseeënd	sightseeën	WKW:ODW:ONV
verliederlijken	verliederlijken	WKW:TGW:INF
verliederlijkt	verliederlijken	WKW:VTD:ONV
verliederlijkt	verliederlijken	WKW:TGW:3EP
verliederlijkte	verliederlijken	WKW:VTD:VRB
wadvaren	wadvaren	WKW:TGW:INF
kinderpop	kinderpop	ZNW:EKV
toproeien	toproeien	WKW:TGW:INF
vijfbaans	vijfbaans	BNW:STL:ONV
tweebaans	tweebaans	BNW:STL:ONV
eetweetje	eetweet	ZNW:EKV:VRK:HET
eetweetjes	eetweet	ZNW:MRV:VRK:DE_
leiderloze	leiderloos	BNW:STL:ONV
afgebabbeld	afgebabbeld	BNW:STL:ONV
carnavallen	carnavallen	WKW:INF:ZNW:HET
eenwieler	eenwieleren	WKW:TGW:1EP
geëenwielerd	eenwieleren	WKW:VTD:ONV
muurparasol	muurparasol	ZNW:MRV:DE_
pimpampet	pimpampetten	WKW:TGW:INF
plankzeilen	plankzeilen	WKW:TGW:INF
sikkeneuren	sikkeneuren	WKW:TGW:INF
bingewatchen	bingewatchen	WKW:INF:ZNW:HET
borstcrawlen	borstcrawlen	WKW:INF:ZNW:HET
partycrashen	partycrashen	WKW:TGW:INF
voetjevrijde	voetjevrijen	WKW:VLT:1EP
voetjevrijden	voetjevrijen	WKW:VLT:INF
voetjevrijt	voetjevrijen	WKW:TGW:3EP
rechterscherm	rechterscherm	BNW:STL:ONV
buitenwaards	buitenwaard	BNW:STL:IET
categorietitels	categorietitel	BNW:STL:MRV:DE_
deurluifels	deurluifel	BNW:STL:IET
dressuurtitels	dressuurtitel	BNW:STL:MRV:DE_
maagbitters	maagbitter	BNW:STL:IET
ongedaanmakings	ongedaanmaking	BNW:STL:IET
paperblanks	paperblank	BNW:STL:IET
supershots	supershot	BNW:STL:IET
topictitels	topictitel	BNW:STL:MRV:DE_
wielremcilinders	wielremcilinder	BNW:STL:IET
volksverbonden	volksverbonden	BNW:STL:ONV
trace	tracen	WKW:TGW:1EP
trace	tracen	WKW:AWS
challengen	challengen	WKW:INF:ZNW:HET
contactgerichte	contactgerichte	BNW:STL:VRB
familie-uitstap	familie-uitstap	ZNW:EKV
KDE	KDE	UNSPECIFIED
magneethoudende	magneethoudende	BNW:STL:VRB
mHz	mHz	UNSPECIFIED
NTG	NTG	UNSPECIFIED
NTU	NTU	UNSPECIFIED
saunaën	saunaën	WKW:TGW:INF
Uli	Uli	UNSPECIFIED
dragon	dragon	ZNW:EKV
trouwtje	trouw	ZNW:EKV:VRK:HET
trouwtjes	trouw	ZNW:MRV:VRK:DE_
refluxen	refluxen	WKW:TGW:INF
sauna	saunaën	WKW:TGW:1EP
saunaden	saunaën	WKW:VLT:INF
uitgeruzied	uitruziën	WKW:VTD:ONV
voorbijijlden	voorbijijlen	WKW:VLT:INF
superbruin	superbruin	BNW:STL:VRB
rheologisch	rheologisch	BNW:STL:ONV
rheologische	rheologisch	BNW:STL:VRB
dieperliggende	dieperliggend	BNW:STL:VRB
rechtevenredige	rechtevenredig	BNW:STL:VRB
Ajax-middenvelder	Ajax-middenvelder	ZNW:EKV:DE_
Amerika-correspondent	Amerika-correspondent	ZNW:EKV:DE_
ChristenUnie-fractie	ChristenUnie-fractie	ZNW:EKV:DE_
ChristenUnie-fracties	ChristenUnie-fractie	ZNW:MRV:DE_
ChristenUnie-leider	ChristenUnie-leider	ZNW:EKV:DE_
GroenLinks-leider	GroenLinks-leider	ZNW:EKV:DE_
GroenLinks-lijsttrekker	GroenLinks-lijsttrekker	ZNW:EKV:DE_
GroenLinks-wethouder	GroenLinks-wethouder	ZNW:EKV:DE_
GroenLinks-wethouders	GroenLinks-wethouder	ZNW:MRV:DE_
Oscar-nominaties	Oscar-nominatie	ZNW:MRV:DE_
Oscar-uitreiking	Oscar-uitreiking	ZNW:EKV:DE_
Philipsburg	Philipsburg	ZNW:EKV:DE_
Surinaams-Nederlands	Surinaams-Nederlands	ZNW:EKV:DE_
Surinaams-Nederlandse	Surinaams-Nederlandse	ZNW:EKV:DE_
aankappen	aankappen	ZNW:MRV:DE_
aanlaat	aanlaat	BNW:STL:VRB
afdroppelen	afdroppelen	UNSPECIFIED
agiotage	agiotage	UNSPECIFIED
altoosdurend	altoosdurend	UNSPECIFIED
aspergesteken	aspergesteken	WKW:TGW:INF
Wespelaar	Wespelaar	ZNW:EKV:DE_
Zaandammer	Zaandammer	ZNW:EKV
Zandvoorde	Zandvoorde	ZNW:EKV:DE_
coïncident	coïncident	UNSPECIFIED
coïncidenten	coïncidenten	UNSPECIFIED
dichtlievende	dichtlievende	UNSPECIFIED
diepdenkende	diepdenkende	BNW:STL:VRB
doodernstige	doodernstige	UNSPECIFIED
geharpuisd	geharpuisd	UNSPECIFIED
geradiografeerd	geradiografeerd	UNSPECIFIED
getrost	getrost	UNSPECIFIED
gevlerkt	gevlerkt	UNSPECIFIED
gevlerkte	gevlerkte	UNSPECIFIED
goedverkochte	goedverkochte	BNW:STL:VRB
goedogende	goedogende	BNW:STL:VRB
groede	groede	UNSPECIFIED
harentwil	harentwil	ZNW:EKV:DE_
harentwille	harentwille	UNSPECIFIED
harpuizen	harpuizen	ZNW:EKV:DE_
hobbelachtige	hobbelachtige	UNSPECIFIED
heensnellen	heensnellen	UNSPECIFIED
heenvoeren	heenvoeren	UNSPECIFIED
hertsleren	hertsleren	UNSPECIFIED
hunnentwille	hunnentwille	UNSPECIFIED
huurdersverzet	huurdersverzet	UNSPECIFIED
instomen	instomen	WKW:TGW:INF
javakoffie	javakoffie	UNSPECIFIED
kristallige	kristallige	UNSPECIFIED
kinderburcht	kinderburcht	UNSPECIFIED
kleptofobie	kleptofobie	UNSPECIFIED
onaanlokkelijke	onaanlokkelijke	UNSPECIFIED
macadamiseren	macadamiseren	UNSPECIFIED
mijnentwil	mijnentwil	ZNW:EKV:DE_
mijnentwille	mijnentwille	UNSPECIFIED
misogamie	misogamie	UNSPECIFIED
moltonnen	moltonnen	ZNW:MRV:DE_
monken	monken	WKW:TGW:INF
moreen	moreen	UNSPECIFIED
narcotine	narcotine	UNSPECIFIED
nettenknoper	nettenknoper	UNSPECIFIED
oceaanhaven	oceaanhaven	UNSPECIFIED
pummelige	pummelige	UNSPECIFIED
omslepen	omslepen	WKW:TGW:INF
omspoken	omspoken	UNSPECIFIED
onderom	onderom	UNSPECIFIED
rococoachtige	rococoachtige	UNSPECIFIED
samengeflanste	samengeflanste	BNW:STL:VRB
samenzwoeren	samenzwoeren	UNSPECIFIED
opponens	opponens	UNSPECIFIED
snoekachtige	snoekachtige	UNSPECIFIED
snoepzieke	snoepzieke	UNSPECIFIED
spreukachtige	spreukachtige	UNSPECIFIED
pleten	pleten	UNSPECIFIED
pummelig	pummelig	UNSPECIFIED
tomaatkleurige	tomaatkleurige	BNW:STL:VRB
rechtopgezet	rechtopgezet	UNSPECIFIED
uitgepoetste	uitgepoetste	BNW:STL:VRB
ressource	ressource	UNSPECIFIED
vastgegespte	vastgegespte	BNW:STL:VRB
spreukachtig	spreukachtig	UNSPECIFIED
geshimmyd	geshimmyd	UNSPECIFIED
godsgenadige	godsgenadige	BNW:STL:VRB
uwentwille	uwentwille	UNSPECIFIED
verreiken	verreiken	WKW:TGW:INF
netelachtige	netelachtige	UNSPECIFIED
ontrefbare	ontrefbare	BNW:STL:VRB
vitamineloos	vitamineloos	UNSPECIFIED
prejudicieerde	prejudicieerde	UNSPECIFIED
voeteren	voeteren	UNSPECIFIED
vroedkundig	vroedkundig	BNW:STL:VRB
wanschapenheid	wanschapenheid	UNSPECIFIED
wederopzeggens	wederopzeggens	UNSPECIFIED
welberaden	welberaden	UNSPECIFIED
winstbijdragen	winstbijdragen	ZNW:MRV:DE_
onverheelde	onverheelde	UNSPECIFIED
inzijpelen	inzijpelen	WKW:TGW:INF
hatsiekadee	hatsiekadee	UNSPECIFIED
magelhaengans	magelhaengans	UNSPECIFIED
pelikaanachtige	pelikaanachtige	UNSPECIFIED
pindarische	pindarische	BNW:STL:VRB
oosterend	oosterend	BNW:STL:ONV
vrijdragende	vrijdragende	BNW:STL:VRB
beachen	beachen	WKW:TGW:INF
rechtsmatige	rechtsmatige	BNW:STL:VRB
ruimteloze	ruimteloze	UNSPECIFIED
suikerbewuste	suikerbewuste	UNSPECIFIED
melkkleurige	melkkleurige	BNW:STL:VRB
wereldgerichte	wereldgerichte	BNW:STL:VRB
slibhoudende	slibhoudende	BNW:STL:VRB
breindode	breindode	UNSPECIFIED
tijdsbepalende	tijdsbepalende	ZNW:EKV:DE_
spijkervrije	spijkervrije	BNW:STL:VRB
hormoonhoudende	hormoonhoudende	BNW:STL:VRB
gevoelsgerichte	gevoelsgerichte	BNW:STL:VRB
plaatsloze	plaatsloze	UNSPECIFIED
frisblauwe	frisblauwe	UNSPECIFIED
substraatloze	substraatloze	UNSPECIFIED
oceaanblauwe	oceaanblauwe	BNW:STL:VRB
stormgevoelige	stormgevoelige	BNW:STL:VRB
wrijvingsvrije	wrijvingsvrije	BNW:STL:VRB
parochiebrede	parochiebrede	UNSPECIFIED
luiervrije	luiervrije	BNW:STL:VRB
bestedingsvrije	bestedingsvrije	BNW:STL:VRB
superblauwe	superblauwe	BNW:STL:VRB
leemkleurige	leemkleurige	BNW:STL:VRB
verwegend	verwegend	BNW:STL:ONV
keuzevrije	keuzevrije	BNW:STL:VRB
vlekgevoelige	vlekgevoelige	BNW:STL:VRB
koelblauwe	koelblauwe	UNSPECIFIED
toeslagvrije	toeslagvrije	BNW:STL:VRB
wijdlopende	wijdlopende	UNSPECIFIED
blauwbruine	blauwbruine	UNSPECIFIED
toetsgerichte	toetsgerichte	BNW:STL:VRB
cameraschuwe	cameraschuwe	UNSPECIFIED
kerngerichte	kerngerichte	BNW:STL:VRB
suikergevoelige	suikergevoelige	BNW:STL:VRB
programmamatige	programmamatige	BNW:STL:VRB
koperblonde	koperblonde	UNSPECIFIED
zomerblauwe	zomerblauwe	BNW:STL:VRB
pindavrije	pindavrije	BNW:STL:VRB
kogelbestendige	kogelbestendige	BNW:STL:VRB
stelmatig	stelmatig	BNW:STL:ONV
taakbewuste	taakbewuste	UNSPECIFIED
keuzeloze	keuzeloze	UNSPECIFIED
feestlichten	feestlicht	UNSPECIFIED
touwspinnen	touwspinnen	UNSPECIFIED
vreesloze	vreesloze	UNSPECIFIED
tempoloze	tempoloze	UNSPECIFIED
vuilgevoelige	vuilgevoelige	BNW:STL:VRB
luchtblauwe	luchtblauwe	BNW:STL:VRB
rijstvrije	rijstvrije	BNW:STL:VRB
gavengerichte	gavengerichte	BNW:STL:VRB
legeringsplaatsen	legeringsplaats	ZNW:EKV
stukgaande	stukgaande	BNW:STL:VRB
koersloze	koersloze	UNSPECIFIED
tastgevoelige	tastgevoelige	BNW:STL:VRB
stootvrije	stootvrije	BNW:STL:VRB
strijdloze	strijdloze	UNSPECIFIED
plotmatige	plotmatige	BNW:STL:VRB
tactmatige	tactmatige	BNW:STL:VRB
steenblauwe	steenblauwe	BNW:STL:VRB
mediabewuste	mediabewuste	UNSPECIFIED
zadelloze	zadelloze	UNSPECIFIED
leugenvrije	leugenvrije	BNW:STL:VRB
kreukgevoelige	kreukgevoelige	BNW:STL:VRB
casusspecifieke	casusspecifieke	UNSPECIFIED
kerkbrede	kerkbrede	UNSPECIFIED
inflatievrije	inflatievrije	BNW:STL:VRB
machtsgerichte	machtsgerichte	BNW:STL:VRB
imagobepalende	imagobepalende	ZNW:EKV:DE_
foutenvrije	foutenvrije	BNW:STL:VRB
lastenvrije	lastenvrije	BNW:STL:VRB
zomerblonde	zomerblonde	UNSPECIFIED
urinebestendige	urinebestendige	BNW:STL:VRB
vergunningloze	vergunningloze	UNSPECIFIED
verstandsloze	verstandsloze	UNSPECIFIED
modelgetrouwe	modelgetrouwe	UNSPECIFIED
vliegtuigloze	vliegtuigloze	UNSPECIFIED
vloervrij	vloervrij	BNW:STL:ONV
smaakvrije	smaakvrije	BNW:STL:VRB
cariësvrije	cariësvrije	BNW:STL:VRB
reflectieloze	reflectieloze	UNSPECIFIED
maatbepalende	maatbepalende	ZNW:EKV:DE_
huurstandplaatsen	huurstandplaats	ZNW:EKV
vliegvrije	vliegvrije	BNW:STL:VRB
kantoorloze	kantoorloze	UNSPECIFIED
catchen	catchen	WKW:TGW:INF
verstandsloos	verstandsloos	UNSPECIFIED
wijntechnische	wijntechnische	BNW:STL:VRB
werkongeschikte	werkongeschikte	UNSPECIFIED
foutengevoelige	foutengevoelige	BNW:STL:VRB
merkgevoelige	merkgevoelige	BNW:STL:VRB
kippenmaïs	kippenmaïs	ZNW:EKV
ringmeesteren	ringmeesteren	UNSPECIFIED
zuigwortel	zuigwortel	UNSPECIFIED
nevelvrije	nevelvrije	BNW:STL:VRB
ozonbestendige	ozonbestendige	UNSPECIFIED
kuurmatige	kuurmatige	BNW:STL:VRB
hoestvrije	hoestvrije	BNW:STL:VRB
escapen	escapen	WKW:TGW:INF
spiertechnische	spiertechnische	BNW:STL:VRB
stofspinnen	stofspinnen	UNSPECIFIED
heavymetalbands	heavymetalband	ZNW:EKV
systeemmatige	systeemmatige	BNW:STL:VRB
voergerichte	voergerichte	BNW:STL:VRB
aanrijdafstanden	aanrijdafstand	ZNW:MRV:DE_
zorgtelefoons	zorgtelefoon	ZNW:EKV
tariefmatige	tariefmatige	BNW:STL:VRB
stopperiodes	stopperiode	ZNW:EKV
wilfen	wilfen	WKW:TGW:INF
triviant	trivianten	WKW:TGW:3EP
shimmy	shimmyen	WKW:TGW:1EP
achteraangelopen	achteraanlopen	WKW:VTD:VRB
achtergehangen	achterhangen	WKW:VTD:VRB
gezien	zien	WKW:VTD:VRB
toegestoten	toestoten	WKW:VTD:VRB
voorgeschreden	voorschrijden	WKW:VTD:VRB
vooruitgezien	vooruitzien	WKW:VTD:VRB
vrijgezwommen	vrijzwemmen	WKW:VTD:VRB
wederverbonden	wederverbinden	WKW:VTD:VRB
gevexeerd	vexeren	WKW:VTD:ONV
vexerend	vexeren	WKW:ODW:ONV
vexere	vexeren	WKW:AWS
Davidson	Davidson	ENM:PER:LST:NIX
Rabobank	Rabobank	ENM:ORG
meewast	meezijn	WKW:VLT:GIJ
zeevissen	zeevissen	WKW:TGW:INF
middel	middel	ZNW:MRV:DE_
Candelaria	Candelaria	ENM:PER:LST:NIX
Davidsons	Davidson	ENM:BEZ
vrouwspecifieke	vrouwspecifiek	BNW:STL:ONV
aanrijdschades	aanrijdschade	ZNW:MRV:DE_
autobuschassis	autobuschassis	ZNW:MRV:DE_
bakwagenchassis	bakwagenchassis	ZNW:MRV:DE_
antiverblinding	antiverblinding	ZNW:MRV:DE_
leidingenstroken	leidingenstrook	ZNW:MRV:DE
lijmfoliestroken	lijmfoliestrook	ZNW:MRV:DE
oogverblinding	oogverblinding	ZNW:MRV:DE_
rechtsspraken	rechtsspraak	ZNW:MRV:DE_
toevloeien	toevloei	ZNW:MRV:DE_
vastgespen	vastgesp	ZNW:MRV:DE_
vastketenen	vastketen	ZNW:MRV:DE_
vastklikken	vastklik	ZNW:MRV:DE_
ab	ab	UNSPECIFIED
profilen	profilen	WKW:TGW:INF
bra	bra	ZNW:MRV:DE_
bijstandsmoeders	bijstandsmoeder	ZNW:BEZ
dolfijnenmoeders	dolfijnenmoeder	ZNW:BEZ
migrantenmoeders	migrantenmoeder	ZNW:BEZ
olifantenmoeders	olifantenmoeder	ZNW:BEZ
onderduikmoeders	onderduikmoeder	ZNW:BEZ
overblijfmoeders	overblijfmoeder	ZNW:BEZ
overgrootmoeders	overgrootmoeder	ZNW:BEZ
oversteekmoeders	oversteekmoeder	ZNW:BEZ
studentenmoeders	studentenmoeder	ZNW:BEZ
surrogaatmoeders	surrogaatmoeder	ZNW:BEZ
voorbeeldmoeders	voorbeeldmoeder	ZNW:BEZ
vuursturen	vuurstuur	ZNW:MRV:DE_
weerszijden	weerszijde	ZNW:MRV:DE_
zeehondenmoeders	zeehondenmoeder	ZNW:BEZ
zelfverblinding	zelfverblinding	ZNW:MRV:DE_
slag	slag	ZNW:EKV:HET
smuil	smuilen	WKW:VLT:1EP
theatraliteit	theatraliteit	ZNW:MRV:DE_
kamp	kamp	ZNW:EKV:DE_
bocht	bocht	ZNW:EKV:HET
deux-pièces	deux-pièces	ZNW:MRV:DE_
plust	bijplussen	WKW:VLT:1EP:LOS
aangedrevene	aandrijven	WKW:VTD:VRB
oversneden	oversnijden	WKW:VTD:ONV
uitscheid	uitscheiden	WKW:TGW:3EP
uitgeschrapt	uitschrappen	WKW:VTD:ONV
uitschrapt	uitschrappen	WKW:TGW:3EP
opschuimer	opschuimer	ZNW:MRV:DE_
vingerbreien	vingerbreien	WKW:TGW:INF
vrijuitgaat	vrijuitgaan	WKW:TGW:3EP
vrijuitgaande	vrijuitgaan	WKW:ODW:VRB
monk	monken	WKW:TGW:1EP
gitaarspelen	gitaarspelen	WKW:INF:ZNW:HET
traaf	traven	WKW:TGW:1EP
getraafd	traven	WKW:VTD:ONV
travend	traven	WKW:ODW:ONV
meezijnde	meezijn	WKW:ODW:VRB
meewaren	meezijn	WKW:VLT:INF
doorvaarde	doorvaren	WKW:VLT:1EP
verreik	verreiken	WKW:TGW:1EP
verreikte	verreiken	WKW:VLT:1EP
verreikt	verreiken	WKW:VTD:ONV
verreikend	verreiken	WKW:ODW:ONV
verreikende	verreiken	WKW:ODW:VRB
verreikt	verreiken	WKW:TGW:3EP
verreikten	verreiken	WKW:VLT:INF
scul	scullen	WKW:TGW:1EP
sculde	scullen	WKW:VLT:1EP
beach	beachen	WKW:TGW:1EP
beachte	beachen	WKW:VLT:1EP
gebeacht	beachen	WKW:VTD:ONV
beacht	beachen	WKW:TGW:3EP
beachten	beachen	WKW:VLT:INF
escape	escapen	WKW:TGW:1EP
escapet	escapen	WKW:TGW:3EP
catch	catchen	WKW:TGW:1EP
gecatcht	catchen	WKW:VTD:ONV
slootjespringen	slootjespringen	WKW:TGW:INF
verweeg	verwegen	WKW:TGW:1EP
verwoog	verwegen	WKW:VLT:1EP
verwogen	verwegen	WKW:VTD:ONV
verwegend	verwegen	WKW:ODW:ONV
verwegende	verwegen	WKW:ODW:VRB
verweegt	verwegen	WKW:TGW:3EP
wilf	wilfen	WKW:TGW:1EP
wilfend	wilfen	WKW:ODW:ONV
ingestoomd	instomen	WKW:VTD:ONV
ingestoomde	instomen	WKW:VTD:VRB
instomend	instomen	WKW:ODW:ONV
instomende	instomen	WKW:ODW:VRB
instoom	instomen	WKW:TGW:1EP
instoomde	instomen	WKW:VLT:1EP
instoomt	instomen	WKW:TGW:3EP
omgesleept	omslepen	WKW:VTD:ONV
inlappen	inlappen	WKW:TGW:INF
inlap	inlappen	WKW:TGW:1EP
inlapt	inlappen	WKW:TGW:3EP
uitbrommen	uitbrommen	WKW:TGW:INF
uitgebromd	uitbrommen	WKW:VTD:ONV
mooi's	mooi	BNW:STL:IET
doorvaarden	doorvaren	WKW:VLT:INF
tweebaans	tweebaans	BNW:STL:VRB
vreen	afvrijen	WKW:VLT:INF:LOS
