# A part-of-speech dictionary that's used additionally to the binary dictionary (*.dict).
# This does not add words to the spell checker, see hunspell/spelling.txt for that.
# File Encoding: UTF-8
# Format: three tab-separated fields: fullform baseform postags
13TV	13TV	NPCNO00
8TV	8TV	NPCNO00
Austen	Austen	NPCNSP0
Bingen	Bingen	NPCSG00
Copperfield	Copperfield	NPCNSP0
Davos	Davos	NPCSG00
FEDER	FEDER	NPMNO00
Fleming	Fleming	NPCNSP0
Gales	Gales	NPCSG00
Gioachino	Gioachino	NPMSSP0
Gulliver	Gulliver	NPMSSP0
Hildegarda	Hildegarda	NPFSSP0
Händel	Händel	NPCNSP0
March	March	NPCNSP0
Mitterrand	Mitterrand	NPCNSP0
MotoGP	MotoGP	NPCNO00
Pergolesi	Pergolesi	NPCNSP0
Rossini	Rossini	NPCNSP0
Schumann	Schumann	NPCNSP0
Schumpeter	Schumpeter	NPCNSP0
Stendhal	Stendhal	NPMSSP0
biomimesis	biomimesis	NCFN000
biomimética	biomimética	NCFS000
biomiméticas	biomimética	NCFP000
multirreincidencia	multirreincidencia	NCFS000
multirreincidencias	multirreincidencia	NCFP000
multirreincidente	multirreincidente	AQ0CS0
multirreincidentes	multirreincidente	AQ0CP0
promercado	promercado	AQ0CN0
schumpeteriana	schumpeteriano	AQ0FS0
schumpeterianas	schumpeteriano	AQ0FP0
schumpeteriano	schumpeteriano	AQ0MS0
schumpeterianos	schumpeteriano	AQ0MP0
