Rand Corporation	NCFSO00
RAND Corporation	NCFSO00
know-how	NCMN000
know how	NCMN000
res publica	NCFS000
a la carbonara	AQ0CN0
L'Équipe	NCMSO00
esfera armilar	NCFS000
dance pop	AQ0CN0
Super Bowl	NPCSO00
World Trade Center	NPMSG00
Santa Coloma	NPFSG00
Theresa May	NPFSSP0
Star Wars	NPCNO00
corta-pega	NPMN000
corta y pega	NPMN000
moto club	NPMS000
moto clubs	NPMP000
call center	NPMS000
call centers	NPMP000
déjà vu	NPMNO00
ménage à trois	NPMNO00
prêt-à-porter	AQ0CN0
D'Hondt	NPCNSP0
City Bank	NPMSO00
Pol Pot	NPCNSP0
New Jersey	NPCSG00
New York	NPCSG00
New England	NPCSG00
New Mexico	NPCSG00
New Orleans	NPCSG00
New Hampshire	NPCSG00
New Providence	NPCSG00
alto cargo	NCCSO00
ex alto cargo	NCCSO00
ex altos cargos	NCCPO00
ex primer ministro	NCMSO00
ex primera ministra	NCFSO00
La Poste	NPCSO00
Santa Cruz	NPCSO00
Mar del Plata	NPCSO00
il prete rosso	NCMS000
Red Bull	NPCNO00
Johann Sebastian	NPMSSP0
La Salle	NPCNO00
cargue y descargue	NCMN000
ida y vuelta	NCCN000
paz y salvo	NCMN000
pop-up	AQ0CN0
pop up	AQ0CN0
New Deal	NCMS000
del mismo modo	LOC_ADV
ultima ratio	NCFS000
## to avoid undesired suggestions in other rules
#corona virus	NCMN000
#salva conducto	NCMS000
#pilla-pilla	NCMS000
#taca-taca	NCMS000
#salva conductos	NCMP000
#salvo conducto	NCMS000
#salvo conductos	NCMP000
#tele trabajo	NCMS000
#tele trabajos	NCMP000
##
de la Puente	NPCNSP0
Carmina Burana	NCCN000
El Abra	NPCSG00
Quintana Roo	NPCSG00
Nuevo León	NPMSG00
tira y afloja	NCMN000
Santa Claus	NPMNSP0
ceda el paso	NCMN000
Nueva York	NPFSG00
euro-zona	NCFS000
taca-taca	NCMS000
el más allá	NCMS000
boca a boca	NCMS000
piedra-papel-tijera	NCMS000
un boca sucia	NCMS000
La Haya	NPFSG00
punto y coma	NCMN000
Mato Grosso	NPMSG00
largo y tendido	LOC_ADV
Santo Domingo	NPMSG00
del todo	LOC_ADV
piruvato deshidrogenasa	NCFS000
CIA World Factbook	NPMSO00
CIA Factbook	NPMSO00
Luz de Gas	NPCSO00
ADN polimerasa	NCFS000
ADN polimerasas	NCFP000
María del Carmen	NPFSSP0
Royal Society	NPFSO00
Royal Academy	NPFSO00
Homo sapiens	NCMN000
Homo habilis	NCMN000
Homo erectus	NCMN000
Homo antecessor	NCMN000
Homo rudolfensis	NCMN000
Homo ergaster	NCMN000
Homo heidelbergensis	NCMN000
Homo neanderthalensis	NCMN000
Homo rhodesiensis	NCMN000
Homo sapiens idaltu	NCMN000
Homo sapiens sapiens	NCMN000
a anequín	LOC_ADV
a asentadillas	LOC_ADV
aa. vv.	Y
AA. VV.	Y
A/A	Y
ab aeterno	LOC_ADV
a barlovento	LOC_ADV
a barrisco	LOC_ADV
a base de bien	LOC_ADV
a base de	LOC_PREP
abastecimiento de agua	LOC_NCMS000
abastecimiento de agua potable	LOC_NCMS000
Abg.	Y
ab initio	LOC_ADV
ab intestato	LOC_ADV
ab irato	LOC_ADV
a boca de cañón	LOC_ADV
a bocajarro	LOC_ADV
abogado defensor	LOC_NC
a bombo y platillo	LOC_ADV
a borbollones	LOC_ADV
a borbotones	LOC_ADV
a bordo	LOC_ADV
a bote pronto	LOC_ADV
ab ovo	LOC_ADV
a brazo partido	LOC_ADV
a bruces	LOC_ADV
a buena cuenta	LOC_ADV
a buena fe	LOC_ADV
a buena luz	LOC_ADV
a buenas horas	LOC_ADV
a buenas noches	LOC_ADV
a buena vista	LOC_ADV
a buen recaudo	LOC_ADV
a buen seguro	LOC_ADV
a buen tino	LOC_ADV
a bulto	LOC_ADV
a cada instante	LOC_ADV
a cada momento	LOC_ADV
a cada paso	LOC_ADV
a cada rato	LOC_ADV
a cada trique	LOC_ADV
a cada triquitraque	LOC_ADV
academia de bellas artes	LOC_NC
a caja y espiga	LOC_ADV
a caliche	LOC_ADV
a cal y canto	LOC_ADV
a cambio de	LOC_PREP
a cambio	LOC_ADV
a campo raso	LOC_ADV
a campo traviesa	LOC_ADV
a cántaros	LOC_ADV
a capela	LOC_ADJ
a cappella	LOC_ADJ
a cara de perro	LOC_ADV
a cara descubierta	LOC_ADV
a carcajada limpia	LOC_ADV
a cargo de	LOC_PREP
a carretadas	LOC_ADV
a carta cabal	LOC_ADV
a casquete quitado	LOC_ADV
a causa de	LOC_PREP
a causa de que	LOC_CS
accidente de trabajo	LOC_NC
accidente laboral	LOC_NC
acción educativa	LOC_NC
acción militar	LOC_NC
acción pública	LOC_NC
aceite de oliva virgen	LOC_NCMS000
a centenares	LOC_ADV
a cepillo	LOC_ADV
acept.	Y
a cerca de	LOC_PREP
acerca de	LOC_PREP
a cercen	LOC_ADV
a cercén	LOC_ADV
a chorros	LOC_ADV
ácido acético	LOC_NCMS000
ácido clorhídrico	LOC_NCMS000
ácido fólico	LOC_NCMS000
ácido láctico	LOC_NCMS000
ácido sulfúrico	LOC_NCMS000
ácido úrico	LOC_NCMS000
a cielo descubierto	LOC_ADV
a ciencia cierta	LOC_ADV
a codazo limpio	LOC_ADV
a comisión	LOC_ADV
a como de lugar	LOC_ADV
a condición de	LOC_PREP
a condición de que	LOC_CS
a consecuencia de	LOC_PREP
a continuación de	LOC_PREP
a contrahílo	LOC_ADV
a contralecho	LOC_ADV
a contramano	LOC_ADV
a contrapelo	LOC_ADV
a contrapié	LOC_ADV
a contra reloj	LOC_ADV
a corazón abierto	LOC_ADV
a cordel	LOC_ADV
a coro	LOC_ADV
a costillas	LOC_ADV
a coxcojilla	LOC_ADV
acre pie	LOC_NC
a cruz y escuadra	LOC_ADV
acta de nacimiento	LOC_NC
acta final	LOC_NC
actividad artística	LOC_NC
actividad económica	LOC_NC
actividad empresarial	LOC_NC
actividades al aire libre	LOC_NCFP000
actividad extraescolar	LOC_NC
actividad financiera	LOC_NC
actividad humana	LOC_NC
actividad industrial	LOC_NC
actividad pesquera	LOC_NC
acto administrativo	LOC_NC
acto impugnado	LOC_NC
acto jurídico	LOC_NC
actuación administrativa	LOC_NC
actuación judicial	LOC_NC
a cuál más	LOC_ADV
a cuatro patas	LOC_ADV
a cuatro pies	LOC_ADV
a cubos	LOC_ADV
a cuenta de	LOC_PREP
acuerdo de paz	LOC_NC
acuerdo internacional	LOC_NC
a cuerpo de rey	LOC_ADV
a cuerpo descubierto	LOC_ADV
a/c	Y
a. C.	Y
ad calendas graecas	LOC_ADV
ad cautelam	LOC_ADV
a. de C.	Y
ad efesios	LOC_ADV
a. de J. C.	Y
además de eso	LOC_ADV
además de	LOC_PREP
además de que	LOC_CS
a dentelladas	LOC_ADV
a dentro	LOC_ADV
a desmano	LOC_ADV
a despecho de	LOC_PREP
a despecho	LOC_ADV
a destajo	LOC_ADV
a destiempo	LOC_ADV
a D. g.	Y
ad hoc	LOC_ADV
ad hominem	LOC_ADV
ad honorem	LOC_ADV
a diario	LOC_ADV
a dicho efecto	LOC_ADV
a diferencia de	LOC_PREP
ad infinitum	LOC_ADV
ad interim	LOC_ADV
a disgusto	LOC_ADV
a distinción de	LOC_PREP
ad libitum	LOC_ADV
ad lib	LOC_ADV
ad litem	LOC_ADV
ad litteram	LOC_ADV
administración civil	LOC_NC
administración del estado	LOC_NC
administración educativa	LOC_NC
administración general	LOC_NC
administración municipal	LOC_NC
admón.	Y
adm.	Y
# a donde	LOC_ADV
a dos dedos de	LOC_PREP
a dos haces	LOC_ADV
a dos manos	LOC_ADV
ad quadrantum	LOC_ADV
ad triangulum	LOC_ADV
a dúo	LOC_ADV
a duras penas	LOC_ADV
ad valorem	LOC_ADV
A. D.	Y
a efecto de que	LOC_CS
a efectos de	LOC_PREP
a empellones	LOC_ADV
aeropuerto internacional	LOC_NC
a escape	LOC_ADV
a escondidas	LOC_ADV
a escondidillas	LOC_ADV
a escote	LOC_ADV
a escuadra	LOC_ADV
a escusa	LOC_ADV
a escusas	LOC_ADV
a eso de	LOC_PREP
a espaldas de	LOC_PREP
a espeta perro	LOC_ADV
a espinapez	LOC_ADV
a espuertas	LOC_ADV
a este lado de	LOC_PREP
a excepción de	LOC_PREP
a expensas de	LOC_PREP
a expensas	LOC_ADV
a fanegadas	LOC_ADV
a favor de	LOC_PREP
a fin de cuentas	LOC_ADV
a fin de	LOC_PREP
a fin de que	LOC_CS
a fines de	LOC_PREP
a flor de agua	LOC_ADV
a flor de piel	LOC_ADV
a flote	LOC_ADV
afma.	Y
afmo.	Y
a fortiori	LOC_ADV
a fuego lento	LOC_ADV
a fuerza de	LOC_PREP
a fuerza de que	LOC_CS
a/f	Y
a gachas	LOC_ADV
a gatas	LOC_ADV
agencia de protección de datos	LOC_NC
agencia de viajes	LOC_NC
agencia espacial europea	LOC_NCFS000
agenda electrónica	LOC_NC
agente social	LOC_NC
Agnus Dei	NCMS000
a gogó	LOC_ADV
a grandes rasgos	LOC_ADV
a granel	LOC_ADV
a graves penas	LOC_ADV
agresión sexual	LOC_NC
agua destilada	LOC_NCFS000
agua dulce	LOC_NCFS000
aguas continentales	LOC_NCFP000
aguas pluviales	LOC_NCFP000
aguas territoriales	LOC_NCFP000
agua subterránea	LOC_NC
agua superficial	LOC_NC
a guisa de	LOC_PREP
ahí es nada	LOC_ADV
ahí le duele	LOC_ADV
a hito	LOC_ADV
ahora bien	LOC_ADV
a horcajadas	LOC_ADV
a hurtadillas	LOC_ADV
aire puro	LOC_NCMS000
aislamiento térmico	LOC_NC
A. I.	Y
a jarros	LOC_ADV
a. J. C.	Y
a jornal	LOC_ADV
a junta continua	LOC_ADV
a juzgar como	LOC_ADV
a juzgar por	LOC_PREP
a la bartola	LOC_ADV
al abrigo de	LOC_PREP
a la buena ventura	LOC_ADV
a la busca de	LOC_PREP
a la chita callando	LOC_ADV
a la cola	LOC_ADV
a la espera de	LOC_PREP
a la funerala	LOC_ADV
a la inversa	LOC_ADV
al alcance de la mano	LOC_ADV
al alimón	LOC_ADV
a la manera de	LOC_PREP
a la mano de Dios	LOC_ADV
a la mitad de	LOC_PREP
a la morisma	LOC_ADV
a la mujeriega	LOC_ADV
al apa	LOC_ADV
a la papillote	LOC_ADV
a la par	LOC_ADV
a la parrilla	LOC_ADV
a la pata coja	LOC_ADV
a la pata llana	LOC_ADV
a la paz de Dios	LOC_ADV
a la pendura	LOC_ADV
a la perfección	LOC_ADV
a lápiz	LOC_ADV
a la postre	LOC_ADV
a la primera de cambio	LOC_ADV
a largas marchas	LOC_ADV
a la ronza	LOC_ADV
a las calladas	LOC_ADV
a la siga de	LOC_PREP
a la sirga	LOC_ADV
a las mil maravillas	LOC_ADV
a la sopa boba	LOC_ADV
a las primeras de cambio	LOC_ADV
a las puertas de la muerte	LOC_ADV
a las veces	LOC_ADV
a lata por canal	LOC_ADV
a la tentaruja	LOC_ADV
a la tirolesa	LOC_ADV
a la usanza de	LOC_PREP
al avemaría	LOC_ADV
a la vez	LOC_ADV
a la vez que	LOC_CS
a la vuelta de	LOC_PREP
a la zona de	LOC_PREP
al bies	LOC_ADV
al cabo de	LOC_PREP
alcaldía mayor	LOC_NCFS000
al calor de	LOC_PREP
al carboncillo	LOC_ADV
al cargo de	LOC_PREP
al centro de	LOC_PREP
al chas chas	LOC_ADV
al cien por cien	LOC_ADV
al cierre del ejercicio	LOC_ADV
al clarear el día	LOC_ADV
alcohol etílico	LOC_NCMS000
al compás de	LOC_PREP
al conjuro de	LOC_PREP
al correr de la pluma	LOC_ADV
al correr del tiempo	LOC_ADV
al decir de	LOC_PREP
al derredor de	LOC_PREP
al derredor	LOC_ADV
al desbarate	LOC_ADV
al descuido y con cuidado	LOC_ADV
al desgaire	LOC_ADV
al detall	LOC_ADV
alea iacta est	LOC_ADV
a legua	LOC_ADV
a leguas	LOC_ADV
al estricote	LOC_ADV
al filo de	LOC_PREP
al filo de mediodía	LOC_ADV
al fin de la jornada	LOC_ADV
al fin y a la postre	LOC_ADV
al fin y al cabo	LOC_ADV
al frente de	LOC_PREP
Alfz.	Y
al gratén	LOC_ADV
al grill	LOC_ADV
alguna que otra vez	LOC_ADV
algunas veces	LOC_ADV
alguno que otro	LOC_ADV
al gusto de	LOC_PREP
al hilo del viento	LOC_ADV
al hilo de mediodía	LOC_ADV
al hilo	LOC_ADV
alianza estratégica	LOC_NC
a libre plática	LOC_ADV
al igual que	LOC_CS
a línea tirada	LOC_ADV
al interior de	LOC_PREP
allá se andan	LOC_ADV
allá se las avenga	LOC_ADV
allá se las componga	LOC_ADV
allá se las haya	LOC_ADV
allá se las hayan	LOC_ADV
allá se van	LOC_ADV
allende de	LOC_PREP
al libre albedrío	LOC_ADV
al lucero del alba	LOC_ADV
alma humana	LOC_NC
alma mater	NCFS000
al mejor tiempo	LOC_ADV
al modo de	LOC_PREP
Almte.	Y
a lo ancho de	LOC_PREP
a lo bestia	LOC_ADV
al objeto de	LOC_PREP
a lo discreto	LOC_ADV
a lo garçon	LOC_ADV
a lo grande	LOC_ADV
a lo largo y a lo ancho	LOC_ADV
a lo largo y ancho de	LOC_PREP
a lo lejos	LOC_ADV
a lo loco	LOC_ADV
al olor de	LOC_PREP
a lo más	LOC_ADV
a lo moderno	LOC_ADV
a lomo	LOC_ADV
a lomos	LOC_ADV
a lo que parece	LOC_ADV
a lo que salga	LOC_ADV
a los cuatro vientos	LOC_ADV
a los piques	LOC_ADV
a lo sumo	LOC_ADV
a lo tonto	LOC_ADV
al otro lado de	LOC_PREP
al paño	LOC_ADV
al par	LOC_ADV
al par que	LOC_CS
al paso que	LOC_CS
al pie de fábrica	LOC_ADV
al pie de la cuesta	LOC_ADV
al pie de la letra	LOC_ADV
al pie de la obra	LOC_ADV
al poco rato	LOC_ADV
al por mayor	LOC_ADV
al por menor	LOC_ADV
al primer envite	LOC_ADV
al primer folio	LOC_ADV
al primer gallo	LOC_ADV
al primer golpe de vista	LOC_ADV
al primer impulso	LOC_ADV
al proviso	LOC_ADV
al punto que	LOC_CS
al rape	LOC_ADV
al raso	LOC_ADV
al rededor	LOC_ADV
al retortero	LOC_ADV
al rojo blanco	LOC_ADV
al rojo cereza	LOC_ADV
al sesgo	LOC_ADV
al socaire de	LOC_PREP
al socaire	LOC_ADV
al tanto de	LOC_PREP
altar mayor	LOC_NCMS000
al temple	LOC_ADV
al tendido	LOC_ADV
al tenor de	LOC_PREP
alter ego	NCMN000
al tiempo que	LOC_CS
alto comisionado de las naciones unidas para los refugiados	LOC_NCMN000
alto el fuego	LOC_NCMS000
al tresbolillo	LOC_ADV
a lumbre de pajas	LOC_ADV
a lumbre mansa	LOC_ADV
al volateo	LOC_ADV
a machamartillo	LOC_ADV
a machote	LOC_ADV
a malas penas	LOC_ADV
a mal dar	LOC_ADV
a manadas	LOC_ADV
a manera de	LOC_PREP
a mano airada	LOC_ADV
a mano armada	LOC_ADV
a manos llenas	LOC_ADV
a mansalva	LOC_ADV
a mares	LOC_ADV
a más andar	LOC_ADV
a más correr	LOC_ADV
a más ganar	LOC_ADV
a más mejor	LOC_ADV
a más no poder	LOC_ADV
a más tardar	LOC_ADV
a más ver	LOC_ADV
a más y mejor	LOC_ADV
a mata caballo	LOC_ADV
a matacaballo	LOC_ADV
a mayor abundamiento	LOC_ADV
a mazo y escoplo	LOC_ADV
ambiente de trabajo	LOC_NC
ambiente familiar	LOC_NC
ambiente social	LOC_NC
ámbito de aplicación	LOC_NC
ámbito territorial	LOC_NC
A. M. D. G.	Y
a mediados de	LOC_PREP
a media ladera	LOC_ADV
a media madera	LOC_ADV
a media margen	LOC_ADV
a media rienda	LOC_ADV
a media rodilla	LOC_ADV
a medias palabras	LOC_ADV
a media voz	LOC_ADV
a medida que	LOC_CS
a mediodía	LOC_ADV
a medio hacer	LOC_ADV
a medio plazo	LOC_ADV
a medios pelos	LOC_ADV
a menos que	LOC_CS
a menudo	LOC_ADV
a mesa puesta	LOC_ADV
a millaradas	LOC_ADV
a mis anchas	LOC_ADV
a mitad de	LOC_PREP
a modo de	LOC_PREP
a montón	LOC_ADV
a mucha honra	LOC_ADV
a muerte	LOC_ADV
a muerte	LOC_AQ0CN0
a muerte o vida	LOC_ADV
a mujeriega	LOC_ADV
a. m.	Y
a nado	LOC_ADV
análisis clínico	LOC_NC
análisis comparativo	LOC_NC
análisis cualitativo	LOC_NC
análisis cuantitativo	LOC_NC
análisis de datos	LOC_NCMN000
análisis del discurso	LOC_NCMN000
análisis de sangre	LOC_NCMN000
análisis económico	LOC_NC
análisis estadístico	LOC_NC
análisis funcional	LOC_NC
análisis histórico	LOC_NC
análisis químico	LOC_NC
anatomía humana	LOC_NCMS000
anatomía patológica	LOC_NCMS000
ancho de banda	LOC_NCMS000
ángela maría	LOC_I
animal salvaje	LOC_NC
año de servicio	LOC_NC
año fiscal	LOC_NC
a nombre de	LOC_PREP
año natural	LOC_NC
año sabático	LOC_NC
a no ser que	LOC_CS
antecedente personal	LOC_NC
ante diem	LOC_ADV
ante meridiem	LOC_ADV
anterior a	LOC_PREP
antes bien	LOC_ADV
antes pues	LOC_ADV
antes que nada	LOC_ADV
antiguo régimen	LOC_NCMS000
antropología cultural	LOC_NCMS000
antropología filosófica	LOC_NCMS000
anuario estadístico	LOC_NCMS000
a ojo de buen cubero	LOC_ADV
a ojos vistas	LOC_ADV
a pan y cuchillo	LOC_ADV
apartado de correos	LOC_NC
aparte de	LOC_PREP
a partir de	LOC_PREP
a pasatoro	LOC_ADV
a paseo	LOC_ADV
a paso de tortuga	LOC_ADV
a paso largo	LOC_ADV
a pasto	LOC_ADV
apdo.	Y
a peón	LOC_ADV
a pesar de	LOC_PREP
a pesar de que	LOC_CS
a pesar de todo	LOC_ADV
a peso de oro	LOC_ADV
a petición de	LOC_PREP
a pica suelta	LOC_ADV
a pico de jarro	LOC_ADV
a pico	LOC_ADV
a pie firme	LOC_ADV
a pie llano	LOC_ADV
a pierna suelta	LOC_ADV
a pipiricojo	LOC_ADV
a pique de maceta	LOC_ADV
a plazo fijo	LOC_ADV
a plazos	LOC_ADV
aplicación informática	LOC_NC
a plomo	LOC_ADV
a poco que	LOC_CS
a poco rato	LOC_ADV
a pocos pasos	LOC_ADV
a porfía	LOC_ADV
a porrillo	LOC_ADV
a pospelo	LOC_ADV
a posteriori	LOC_ADV
a pote	LOC_ADV
apoyo docente	LOC_NC
apoyo escolar	LOC_NC
apoyo financiero	LOC_NC
apoyo logístico	LOC_NC
apoyo psicológico	LOC_NC
apoyo social	LOC_NC
apoyo técnico	LOC_NC
a precio de coste	LOC_ADV
aprendizaje significativo	LOC_NCMS000
a primera sangre	LOC_ADV
a primera sangre	LOC_AQ0CN0
a principios de	LOC_PREP
a priori	LOC_ADV
a prisa	LOC_ADV
a propósito de	LOC_PREP
a prorrata	LOC_ADV
a prueba de	LOC_PREP
a puchos	LOC_ADV
a puerta cerrada	LOC_ADV
a puestas	LOC_ADV
a puñados	LOC_ADV
a puño cerrado	LOC_ADV
a punta de lanza	LOC_ADV
a punta de pistola	LOC_ADV
a punta pala	LOC_ADV
a puntapiés	LOC_ADV
a punto de caramelo	LOC_ADV
a punto de	LOC_PREP
a punto de que	LOC_CS
a punto de solfa	LOC_ADV
a punto fijo	LOC_ADV
a punto largo	LOC_ADV
a pupilo	LOC_ADV
ap.	Y
a quema ropa	LOC_ADV
a quemarropa	LOC_ADV
a rachas	LOC_ADV
a raíz de	LOC_PREP
a raja tabla	LOC_ADV
a rajatabla	LOC_ADV
a ras de	LOC_PREP
a ras del suelo	LOC_ADV
a ras de tierra	LOC_ADV
a rastras	LOC_ADV
arate cavate	LOC_ADV
a ratos perdidos	LOC_ADV
a raudales	LOC_ADV
a razón de	LOC_PREP
árbol frutal	LOC_NC
árbol genealógico	LOC_NC
archivo general	LOC_NC
a reculones	LOC_ADV
a regaña dientes	LOC_ADV
a regañadientes	LOC_ADV
a rehala	LOC_ADV
a rembolso	LOC_ADV
a remiendos	LOC_ADV
a remojo	LOC_ADV
a remo	LOC_ADV
a renglón seguido	LOC_ADV
a reo	LOC_ADV
a repecho	LOC_ADV
a repelo	LOC_ADV
a repelones	LOC_ADV
a reserva de	LOC_PREP
a resto abierto	LOC_ADV
ares y mares	LOC_ADV
a retaguardia de	LOC_PREP
a revienta cinchas	LOC_ADV
a rienda suelta	LOC_ADV
a riesgo de	LOC_PREP
a riesgo y ventura	LOC_ADV
a río revuelto	LOC_ADV
arma biológica	LOC_NC
arma nuclear	LOC_NC
arma química	LOC_NC
a rodeabrazo	LOC_ADV
a rompejunta	LOC_ADV
a rostro firme	LOC_ADV
arquitecto técnico	LOC_NC
arquitectura popular	LOC_NCFS000
Arq.	Y
arreglo floral	LOC_NC
arroz abanda	NCMS000
arroz blanco	LOC_NCMS000
art déco	AQ0CN0
arte contemporáneo	LOC_NCCS000
arte dramático	LOC_NCCS000
arte medieval	LOC_NCCS000
arte moderno	LOC_NCCS000
arte popular	LOC_NC
artes aplicadas	LOC_NCCP000
artes audiovisuales	LOC_NCCP000
art nouveau	AQ0CN0
art nouveau	LOC_NCMS000
art.º	Y
art.	Y
a ruche	LOC_ADV
A. R.	Y
Arz.	Y
a sabiendas	LOC_ADV
a salto de mata	LOC_ADV
a saltos	LOC_ADV
asamblea general extraordinaria	LOC_NCFS000
asamblea general	LOC_NCFS000
asamblea general ordinaria	LOC_NCFS000
asamblea nacional constituyente	LOC_NCFS000
asamblea plenaria	LOC_NCFS000
asamblea popular	LOC_NCFS000
a sangre caliente	LOC_ADV
a sangre fría	LOC_ADV
a sangre y fuego	LOC_ADV
a santo de qué	LOC_ADV
a sardinel	LOC_ADV
a seguir bien	LOC_ADV
a semejanza de	LOC_PREP
asesor fiscal	LOC_NC
asesoría jurídica	LOC_NC
asesoría legal	LOC_NC
asesor jurídico	LOC_NC
asesor legal	LOC_NC
asesor técnico	LOC_NC
así como también	LOC_ADV
así como tampoco	LOC_ADV
asilo político	LOC_NCMS000
así pues	LOC_ADV
asistencia legal	LOC_NC
asistencia sanitaria	LOC_NCFS000
asistencia técnica	LOC_NCFS000
así y todo	LOC_ADV
asma bronquial	LOC_NCFS000
a sobre haz	LOC_ADV
a sobremano	LOC_ADV
a sobre peine	LOC_ADV
a so capa	LOC_ADV
a socapa	LOC_ADV
asociación civil	LOC_NC
asociación de empresarios	LOC_NC
asociación de vecinos	LOC_NC
asociación empresarial	LOC_NC
asociación profesional	LOC_NC
a soga	LOC_ADV
a solapo	LOC_ADV
a solas	LOC_ADV
a solaz	LOC_ADV
a sotamano	LOC_ADV
a sotavento	LOC_ADV
a su imagen y semejanza	LOC_ADV
a suplicación de	LOC_PREP
a súplica de	LOC_PREP
a sus anchas	LOC_ADV
A. S.	Y
a tal punto que	LOC_CS
a teja vana	LOC_ADV
atención al cliente	LOC_NCFS000
atención directa	LOC_NCFS000
atención domiciliaria	LOC_NCFS000
atención médica	LOC_NCFS000
atención personal	LOC_NCFS000
atención sanitaria	LOC_NCFS000
atención temprana	LOC_NCFS000
a tenor de	LOC_PREP
a tientas	LOC_ADV
a tiento	LOC_ADV
a tirada	LOC_ADV
a tiro de ballesta	LOC_ADV
a tiro de pistola	LOC_ADV
a tiro limpio	LOC_ADV
a título de	LOC_PREP
a tizón	LOC_ADV
a toca ropa	LOC_ADV
a toca teja	LOC_ADV
a tocateja	LOC_ADV
a toda brida	LOC_ADV
a toda costa	LOC_ADV
a toda furia	LOC_ADV
a toda hostia	LOC_ADV
a toda leche	LOC_ADV
a toda ley	LOC_ADV
a toda máquina	LOC_ADV
a toda marcha	LOC_ADV
a toda mecha	LOC_ADV
a toda pastilla	LOC_ADV
a toda plana	LOC_ADV
a toda prisa	LOC_ADV
a toda rienda	LOC_ADV
a todas estas	LOC_ADV
a todas horas	LOC_ADV
a todo andar	LOC_ADV
a todo correr	LOC_ADV
a todo evento	LOC_ADV
a todo gas	LOC_ADV
a todo lo largo de	LOC_PREP
a todo lo largo	LOC_ADV
a todo meter	LOC_ADV
a todo moler	LOC_ADV
a todo pasto	LOC_ADV
a todo riesgo	LOC_ADV
a todo ruedo	LOC_ADV
a todo tirar	LOC_ADV
a todo trance	LOC_ADV
a todo vapor	LOC_ADV
a tontas y a locas	LOC_ADV
a topa tolondro	LOC_ADV
a tope	LOC_ADV
a toque de campana	LOC_ADV
a torna peón	LOC_ADV
a torna punta	LOC_ADV
a torno	LOC_ADV
a traición	LOC_ADV
a trancas y barrancas	LOC_ADV
a trancos	LOC_ADV
a traque barraque	LOC_ADV
a través de	LOC_PREP
a troche y moche	LOC_ADV
a trompa y talega	LOC_ADV
a trompicones	LOC_ADV
a tropezones	LOC_ADV
a trueco de	LOC_PREP
a trueque	LOC_ADV
atta.	Y
atte.	Y
atto.	Y
a tuertas	LOC_ADV
a tuertas o a derechas	LOC_ADV
a tuerto o a derecho	LOC_ADV
a tutiplén	LOC_ADV
A. T.	Y
audición y lenguaje	LOC_NCFS000
audiencia nacional	LOC_NCFS000
audiencia provincial	LOC_NC
auditoría de cuentas	LOC_NC
auditoría externo	LOC_NC
auditoría interno	LOC_NC
aula de informática	LOC_NC
a ultranza	LOC_ADV
aumento de precio	LOC_NC
aún así	LOC_ADV
aún con eso	LOC_ADV
aún cuando	LOC_ADV
a un lado de	LOC_PREP
a un lado y otro	LOC_ADV
a uno y otro lado	LOC_ADV
a un solo efecto	LOC_ADV
a upa	LOC_ADV
aurea mediocritas	LOC_ADV
a usanza de	LOC_PREP
automóvil club	LOC_NCMS000
autonomía personal	LOC_NCFS000
autoridad laboral	LOC_NC
autorización expresa	LOC_NC
autorización judicial	LOC_NC
autorización previa	LOC_NC
avda.	Y
avd.	Y
a veces	LOC_ADV
a vez que	LOC_CS
a vida o muerte	LOC_ADV
a vista de pájaro	LOC_ADV
a viva voz	LOC_ADV
a voz en cuello	LOC_ADV
a voz en grito	LOC_ADV
a vuela pluma	LOC_ADV
a vuelapluma	LOC_ADV
a vuelco de dado	LOC_ADV
a vuelta de correo	LOC_ADV
a vuelta de	LOC_PREP
a vuelta de ojo	LOC_ADV
a vuelta de ojos	LOC_ADV
a.	Y
a. C.	Y
A. D.	Y
a. de C.	Y
a. de J. C.	Y
A. I.	Y
a. J. C.	Y
a. m.	Y
A. M. D. G.	Y
A. R.	Y
A. S.	Y
A. T.	Y
A/A	Y
a/c	Y
a/f	Y
AA. VV.	Y
aa. vv.	Y
ab aeterno	LOC_ADV
ab initio	LOC_ADV
ab intestato	LOC_ADV
ab irato	LOC_ADV
ab ovo	LOC_ADV
Abg.	Y
acept.	Y
acerca de	LOC_PREP
ad calendas graecas	LOC_ADV
ad cautelam	LOC_ADV
ad efesios	LOC_ADV
ad hoc	LOC_ADV
ad hominem	LOC_ADV
ad honorem	LOC_ADV
ad infinitum	LOC_ADV
ad interim	LOC_ADV
ad lib	LOC_ADV
ad libitum	LOC_ADV
ad litem	LOC_ADV
ad litteram	LOC_ADV
ad quadrantum	LOC_ADV
ad triangulum	LOC_ADV
ad valorem	LOC_ADV
además de	LOC_PREP
además de eso	LOC_ADV
además de que	LOC_CS
adm.	Y
admón.	Y
afma.	Y
afmo.	Y
Agnus Dei	NCMS000
ahora bien	LOC_ADV
ahí es nada	LOC_ADV
ahí le duele	LOC_ADV
al abrigo de	LOC_PREP
al alcance de la mano	LOC_ADV
al alimón	LOC_ADV
al apa	LOC_ADV
al avemaría	LOC_ADV
al bies	LOC_ADV
al cabo de	LOC_PREP
al calor de	LOC_PREP
al carboncillo	LOC_ADV
al cargo de	LOC_PREP
al centro de	LOC_PREP
al chas chas	LOC_ADV
al cien por cien	LOC_ADV
al cierre del ejercicio	LOC_ADV
al clarear el día	LOC_ADV
al compás de	LOC_PREP
al conjuro de	LOC_PREP
al correr de la pluma	LOC_ADV
al correr del tiempo	LOC_ADV
al decir de	LOC_PREP
al derredor	LOC_ADV
al derredor de	LOC_PREP
al desbarate	LOC_ADV
al descuido y con cuidado	LOC_ADV
al desgaire	LOC_ADV
al detall	LOC_ADV
al estricote	LOC_ADV
al filo de	LOC_PREP
al filo de mediodía	LOC_ADV
al fin de la jornada	LOC_ADV
al fin y a la postre	LOC_ADV
al fin y al cabo	LOC_ADV
al frente de	LOC_PREP
al gratén	LOC_ADV
al grill	LOC_ADV
al gusto de	LOC_PREP
al hilo	LOC_ADV
al hilo de mediodía	LOC_ADV
al hilo del viento	LOC_ADV
al igual que	LOC_CS
al interior de	LOC_PREP
al libre albedrío	LOC_ADV
al lucero del alba	LOC_ADV
al mejor tiempo	LOC_ADV
al modo de	LOC_PREP
al objeto de	LOC_PREP
al olor de	LOC_PREP
al otro lado de	LOC_PREP
al par	LOC_ADV
al par que	LOC_CS
al paso que	LOC_CS
al paño	LOC_ADV
al pie de fábrica	LOC_ADV
al pie de la cuesta	LOC_ADV
al pie de la letra	LOC_ADV
al pie de la obra	LOC_ADV
al poco rato	LOC_ADV
al por mayor	LOC_ADV
al por menor	LOC_ADV
al primer envite	LOC_ADV
al primer folio	LOC_ADV
al primer gallo	LOC_ADV
al primer golpe de vista	LOC_ADV
al primer impulso	LOC_ADV
al proviso	LOC_ADV
al punto que	LOC_CS
al rape	LOC_ADV
al raso	LOC_ADV
al rededor	LOC_ADV
al retortero	LOC_ADV
al rojo blanco	LOC_ADV
al rojo cereza	LOC_ADV
al sesgo	LOC_ADV
al socaire	LOC_ADV
al socaire de	LOC_PREP
al tanto de	LOC_PREP
al temple	LOC_ADV
al tendido	LOC_ADV
al tenor de	LOC_PREP
al tiempo que	LOC_CS
al tresbolillo	LOC_ADV
al volateo	LOC_ADV
alea iacta est	LOC_ADV
Alfz.	Y
alguna que otra vez	LOC_ADV
algunas veces	LOC_ADV
alguno que otro	LOC_ADV
allende de	LOC_PREP
allá se andan	LOC_ADV
allá se las avenga	LOC_ADV
allá se las componga	LOC_ADV
allá se las haya	LOC_ADV
allá se las hayan	LOC_ADV
allá se van	LOC_ADV
alma mater	NCFS000
Almte.	Y
alter ego	NCMN000
ante diem	LOC_ADV
ante meridiem	LOC_ADV
anterior a	LOC_PREP
antes bien	LOC_ADV
antes pues	LOC_ADV
antes que nada	LOC_ADV
ap.	Y
aparte de	LOC_PREP
apdo.	Y
aprox.	Y
arate cavate	LOC_ADV
ares y mares	LOC_ADV
Arq.	Y
arroz abanda	NCMS000
art déco	AQ0CN0
art deco	AQ0CN0
art decó	AQ0CN0
Art Déco	AQ0CN0
Art Deco	AQ0CN0
Art Decó	AQ0CN0
art nouveau	AQ0CN0
Art Nouveau	AQ0CN0
Art Brut	AQ0CN0
art brut	AQ0CN0
art.	Y
art.º	Y
Arz.	Y
así como también	LOC_ADV
así como tampoco	LOC_ADV
así pues	LOC_ADV
así y todo	LOC_ADV
atta.	Y
atte.	Y
atto.	Y
aurea mediocritas	LOC_ADV
av.	Y
avd.	Y
avda.	Y
ayer noche	LOC_ADV
ayuda a domicilio	LOC_NCFS000
ayuda humanitaria	LOC_NCFS000
ayuda oficial	LOC_NC
bajo cuerda	LOC_ADV
bajo el poder de	LOC_PREP
bajo juramento	LOC_ADV
bajo la responsabilidad de	LOC_PREP
bajo llave	LOC_ADV
bajo mano	LOC_ADV
bajo ningún concepto	LOC_ADV
bajo siete llaves	LOC_ADV
banco bilbao vizcaya argentaria	LOC_NCMS000
banco central europeo	LOC_NCMS000
banco de pruebas	LOC_NC
banco de sangre	LOC_NC
banco mundial	LOC_NCMS000
banco nacional	LOC_NCMS000
banco santander central hispano	LOC_NCMS000
banda ancha	LOC_NCFS000
bandera nacional	LOC_NC
bandera roja	LOC_NCFS000
Barna.	Y
base de cálculo	LOC_NC
base jurídica	LOC_NC
Bco.	Y
bel canto	NCMS000
belle époque	NCFS000
best seller	NCMN000
biblioteca pública	LOC_NC
Bibl.	Y
bien de capital	LOC_NC
bien entendido que	LOC_CS
bienestar social	LOC_NCMS000
bien mirado	LOC_ADV
bien patrimonial	LOC_NC
bien público	LOC_NC
bien que mal	LOC_ADV
bien sabe Dios que	LOC_CS
big band	NCMS000
big bands	NCMP000
big bang	NCMS000
Big Bang	NCMS000
biología molecular	LOC_NCMS000
bioquímica clínica	LOC_NCMS000
black jack	NCMS000
b. l. m.	Y
bloqueo económico	LOC_NCMS000
blue jean	NCMS000
blue jeans	NCMP000
Bma.	Y
Bmo.	Y
bóbilis bóbilis	LOC_ADV
boca arriba	LOC_ADV
boletín oficial del estado	LOC_NCMS000
boletín oficial de navarra	LOC_NCMS000
bolsa de comercio	LOC_NCFS000
bolsa de plástico	LOC_NC
bosque tropical	LOC_NC
B.º	Y
Bo.	Y
boy scout	NCMS000
boy scouts	NCMP000
Boy Scout	NCMS000
Boy Scouts	NCMP000
break dance	NCMS000
Brig.	Y
Brutus Brutus	NPCNSP0
Bs. As.	Y
Bta.	Y
Bto.	Y
Buenos Aires	NPCSG00
Burkina Faso	NPCSG00
buzón de correo electrónico	LOC_NC
buzón de correo	LOC_NC
B.	Y
cada cosa por su lado	LOC_ADV
cada dos por tres	LOC_ADV
cada quisque	NCMS000
cadena de producción	LOC_NC
cadena de tiendas	LOC_NC
caja de herramientas	LOC_NC
caj.	Y
calamo currente	LOC_ADV
cálamo currente	LOC_ADV
calidad asistencial	LOC_NCFS000
calidad del agua	LOC_NCFS000
calidad de vida	LOC_NCFS000
cámara alta	LOC_NCFS000
cámara baja	LOC_NCFS000
cámara de representantes	LOC_NCFS000
cámara web	LOC_NC
cambio climático	LOC_NCMS000
cambio de gobierno	LOC_NC
cambio de uso	LOC_NCMS000
campaña de promoción	LOC_NC
campaña electoral	LOC_NC
campaña política	LOC_NC
campeonato mundial	LOC_NC
campeonato nacional	LOC_NC
campeón mundial	LOC_NC
campo de aplicación	LOC_NC
campo de fútbol	LOC_NC
campo de golf	LOC_NC
campo de juego	LOC_NC
campo eléctrico	LOC_NC
campo magnético	LOC_NC
campus universitario	LOC_NC
canción de amor	LOC_NC
cantidad de energía	LOC_NCFS000
cantidad de información	LOC_NCFS000
capacidad creativa	LOC_NC
capacidad de aprendizaje	LOC_NCFS000
capacidad de obrar	LOC_NCFS000
capacidad jurídica	LOC_NC
capacidad legal	LOC_NC
capacidad operativa	LOC_NC
Cap. Fed.	Y
capin melao	LOC_ADV
capital de riesgo	LOC_NCFS000
capital humano	LOC_NCFS000
capital riesgo	LOC_NCFS000
cap.º	Y
captura de datos	LOC_NC
Cap.	Y
cap.	Y
cara abajo	LOC_ADV
cara a cara	LOC_ADV
cara arriba	LOC_ADV
carga de trabajo	LOC_NC
carga eléctrica	LOC_NC
carnet de conducir	LOC_NC
carpe diem	LOC_ADV
carta apostólica	LOC_NC
carta certificada	LOC_NC
carta de las naciones unidas	LOC_NCFS000
carta magna	LOC_NC
cartera de clientes	LOC_NC
cartera de valores	LOC_NC
casa museo	NCFS000
casa rural	LOC_NC
casas museo	NCFP000
casi geostrófico	LOC_ADV
casi que	LOC_CS
Cástor y Pólux	LOC_ADV
casus belli	LOC_ADV
C. A.	Y
C.ª	Y
c/c	Y
C. C.	Y
c. c.	Y
Cdad.	Y
celebración eucarística	LOC_NC
censo de población	LOC_NC
centímetro cuadrado	LOC_NC
centímetro cúbico Fh segundo	LOC_NC
centímetro cúbico	LOC_NC
centímetro cúbico por segundo	LOC_NC
centímetro de hg	LOC_NC
centímetro de mercurio	LOC_NC
centímetro Fh segundo	LOC_NC
centímetro Fh s	LOC_NC
centímetro por segundo	LOC_NC
centímetro segundo	LOC_NC
central hidroeléctrica	LOC_NC
central nuclear	LOC_NC
central térmica	LOC_NC
centro asistencial	LOC_NC
centro cívico	LOC_NC
centro de atención al cliente	LOC_NC
centro de día	LOC_NC
centro de documentación	LOC_NC
centro de gestión	LOC_NC
centro de rehabilitación	LOC_NC
centro escolar	LOC_NC
centro hospitalario	LOC_NC
centro penitenciario	LOC_NC
cent.	Y
cént.	Y
cepillo de dientes	LOC_NC
ceremonia de clausura	LOC_NC
certificado de asistencia	LOC_NC
certificado de estudios	LOC_NC
certificado de nacimiento	LOC_NC
c. e.	Y
cfr.	Y
c. f. s.	Y
C. F.	Y
cf.	Y
cgo.	Y
chaise longue	NCFS000
cheque certificado	LOC_NC
chill out	NCMS000
chino mandarín	LOC_NC
chorro de agua	LOC_NC
ch/	Y
Cía.	Y
ciclo económico	LOC_NC
ciclo formativo	LOC_NC
ciclo vital	LOC_NC
ciencia biológica	LOC_NC
ciencia de la educación	LOC_NC
ciencia de la naturaleza	LOC_NC
ciencia empresarial	LOC_NC
cien por cien	LOC_ADV
ciento por ciento	LOC_ADV
ciento y la madre	LOC_ADV
cifra de negocio	LOC_NC
cine de terror	LOC_NCMS000
cine documental	LOC_NCMS000
cine erótico	LOC_NCMS000
cine fantástico	LOC_NCMS000
cinta adhesiva	LOC_NCFS000
circuito cerrado	LOC_NC
circulación sanguínea	LOC_NCFS000
cirugía torácica	LOC_NCFS000
cirugía vascular	LOC_NCFS000
C. I.	Y
cje.	Y
clase obrera	LOC_NCFS000
clase política	LOC_NCFS000
clase social	LOC_NC
clase trabajadora	LOC_NC
claustro de profesores	LOC_NC
clave de acceso	LOC_NC
clima mediterráneo	LOC_NCMS000
clima templado	LOC_NCMS000
clima tropical	LOC_NCMS000
cl.	Y
cm3 Fh seg	LOC_NCFS000
cm3 Fh s	LOC_NCFS000
Cmdt.	Y
cm Fh s	LOC_NCFS000
Cmte.	Y
Cnel.	Y
cochite hervite	LOC_ADV
código de comercio	LOC_NC
código de identificación	LOC_NC
código ético	LOC_NC
código fuente	LOC_NCMS000
código genético	LOC_NCMS000
codo a codo	LOC_ADV
codo con codo	LOC_ADV
cód.	Y
coitus interruptus	NCMN000
colección privada	LOC_NC
colegio de abogados	LOC_NC
colegio nacional	LOC_NC
colegio público	LOC_NC
Col.	Y
col.	Y
comandante en jefe	LOC_NCCS000
comercio bilateral	LOC_NCMS000
comercio justo	LOC_NCMS000
comisión asesora	LOC_NC
comisión de evaluación	LOC_NC
comisión de gobierno	LOC_NC
comisión económica	LOC_NC
comisión ejecutiva	LOC_NC
comisiones obreras	LOC_NCFP000
comisión europea	LOC_NCFS000
comisión mixta	LOC_NC
comisión nacional del mercado de valores	LOC_NCFS000
comisión negociadora	LOC_NC
comisión paritaria	LOC_NC
comisión parlamentaria	LOC_NC
comité central del partido	LOC_NCMS000
comité económico y social	LOC_NCMS000
comité ejecutivo	LOC_NCMS000
comité olímpico internacional	LOC_NCMS000
comité organizador	LOC_NCMS000
como ahora es de día	LOC_ADV
como alma que lleva el diablo	LOC_ADV
como a los ojos de su cara	LOC_ADV
como a real de enemigo	LOC_ADV
como caído de las nubes	LOC_ADV
como de la noche al día	LOC_ADV
como dos y dos son cuatro	LOC_ADV
Comod.	Y
como el convidado de piedra	LOC_ADV
como el día a la noche	LOC_ADV
como el perro y el gato	LOC_ADV
como es debido	LOC_ADV
como es de día	LOC_ADV
como está mandado	LOC_ADV
como estamos aquí tú y yo	LOC_ADV
como hay Dios	LOC_ADV
como hecho de encargo	LOC_ADV
como la palma de la mano	LOC_ADV
como los chorros del oro	LOC_ADV
como mínimo	LOC_ADV
como mucho	LOC_ADV
como oro en paño	LOC_ADV
como Pedro por su casa	LOC_ADV
como por ensalmo	LOC_ADV
como que	LOC_CS
como quien dice	LOC_ADV
como quien no quiere la cosa	LOC_ADV
como quien oye llover	LOC_ADV
como quiera que	LOC_CS
como si no hubiera dicho nada	LOC_ADV
como si tal cosa	LOC_ADV
como un pepe	LOC_ADV
compact disc	LOC_NCMS000
compañero de equipo	LOC_NC
compañía aérea	LOC_NC
compañía de jesús	LOC_NCFS000
compensación económica	LOC_NC
complejo turístico	LOC_NC
comportamiento humano	LOC_NCMS000
comportamiento sexual	LOC_NC
comportamiento social	LOC_NC
composición musical	LOC_NC
comprensión lectora	LOC_NCFS000
compromiso político	LOC_NC
Comp.	Y
Comte.	Y
comunicación de datos	LOC_NCFS000
comunicación oral	LOC_NCFS000
comunicación verbal	LOC_NCFS000
comunidad económica europea	LOC_NCFS000
comunidad europea	LOC_NCFS000
comunidad humana	LOC_NC
con carácter de	LOC_PREP
concesión administrativa	LOC_NC
conciencia colectiva	LOC_NCFS000
conciencia nacional	LOC_NCFS000
conciencia pública	LOC_NCFS000
conciencia social	LOC_NCFS000
concilio vaticano II	LOC_NCMN000
con claridad meridiana	LOC_ADV
con conocimiento de causa	LOC_ADV
con creces	LOC_ADV
condiciones ambientales	LOC_NCFP000
condiciones atmosféricas	LOC_NCFP000
condiciones de venta	LOC_NCFP000
condiciones de vida	LOC_NCFP000
condiciones económicas	LOC_NCFP000
condiciones generales	LOC_NCFP000
conducta humana	LOC_NCFS000
con efecto desde	LOC_PREP
con el culo al aire	LOC_ADV
con el ojo tan largo	LOC_ADV
con el sudor de la frente	LOC_ADV
con excepción de	LOC_PREP
conexión a la red	LOC_NCFS000
conferencia episcopal	LOC_NCFS000
conferencia mundial	LOC_NCFS000
conflicto armado	LOC_NC
conflicto social	LOC_NC
conforme a	LOC_PREP
cónfr.	Y
cónf.	Y
congregación para la doctrina de la fe	LOC_NCMN000
congreso eucarístico	LOC_NCMS000
congreso nacional	LOC_NCMS000
con honores de	LOC_PREP
con la ayuda de Dios	LOC_ADV
con la boca abierta	LOC_ADV
con la casa a cuestas	LOC_ADV
con la condición de	LOC_PREP
con la espada desnuda	LOC_ADV
con la frente alta	LOC_ADV
con la frente bien alta	LOC_ADV
con la frente levantada	LOC_ADV
con la lengua de un palmo	LOC_ADV
con la lengua fuera	LOC_ADV
con la mano en el corazón	LOC_ADV
con la música a otra parte	LOC_ADV
con las manos cruzadas	LOC_ADV
con las manos vacías	LOC_ADV
con la soga al cuello	LOC_ADV
con las orejas caídas	LOC_ADV
con las orejas gachas	LOC_ADV
con las orejas tan largas	LOC_ADV
con las piernas cruzadas	LOC_ADV
con la vida en un hilo	LOC_ADV
con lo que respecta a	LOC_PREP
con los cinco sentidos	LOC_ADV
con los ojos cerrados	LOC_ADV
con los pies delante	LOC_ADV
con mala idea	LOC_ADV
con mal pie	LOC_ADV
con mano escasa	LOC_ADV
con mano pesada	LOC_ADV
con mil amores	LOC_ADV
con miquis	LOC_ADV
con miras a	LOC_PREP
con moto	LOC_ADV
con mucho gusto	LOC_ADV
con objeto de	LOC_PREP
con objeto que	LOC_CS
con ocasión de	LOC_PREP
conocimiento científico	LOC_NCMS000
conocimiento humano	LOC_NCMS000
con pelos y señales	LOC_ADV
con pies de plomo	LOC_ADV
con puntos y comas	LOC_ADV
con relación a	LOC_PREP
con respecto a	LOC_PREP
con respecto de	LOC_PREP
consecutio temporum	LOC_ADV
consejo de estado	LOC_NC
consejo de europa	LOC_NCMS000
consejo de la unión europea	LOC_NCMS000
consejo de ministros	LOC_NC
consejo de seguridad de las naciones unidas	LOC_NCMS000
consejo de seguridad	LOC_NCMS000
consejo directivo	LOC_NC
consejo económico y social	LOC_NCMS000
consejo ejecutivo	LOC_NC
consejo municipal	LOC_NC
consejo nacional	LOC_NC
consejo permanente	LOC_NC
conservatorio de música	LOC_NC
con solo que	LOC_CS
con sordina	LOC_ADV
construcción naval	LOC_NCFS000
consulta popular	LOC_NC
contabilidad financiera	LOC_NCFS000
con tal de	LOC_PREP
con tal de que	LOC_CS
con tal que	LOC_CS
contaminación acústica	LOC_NCFS000
contaminación ambiental	LOC_NCFS000
contaminación atmosférica	LOC_NCFS000
contaminación del agua	LOC_NCFS000
con toda la barba	LOC_ADV
con toda la boca	LOC_ADV
con toda normalidad	LOC_ADV
con todas las de la ley	LOC_ADV
con todo y con eso	LOC_ADV
contradictio in terminis	NCFS000
Contralmte.	Y
contra reloj	LOC_ADV
contra rembolso	LOC_ADV
contratación de personal	LOC_NCFS000
contrato de obra	LOC_NC
contrato social	LOC_NC
contra viento y marea	LOC_ADV
control de flujo	LOC_NCMS000
control de gestión	LOC_NCMS000
control médico	LOC_NC
control numérico	LOC_NCMS000
con uñas y dientes	LOC_ADV
con un palmo de lengua	LOC_ADV
con valor de	LOC_PREP
convención de ginebra	LOC_NCMS000
convención europea	LOC_NC
con viento fresco	LOC_ADV
con vistas a	LOC_PREP
con zurrapas	LOC_ADV
cooperación económica	LOC_NCFS000
coord.ª	Y
coordenadas geográficas	LOC_NCFS000
coord.	Y
copa de europa	LOC_NC
copa intercontinental	LOC_NC
coram populo	LOC_ADV
córam pópulo	LOC_ADV
corpore insepulto	LOC_ADV
correlación de fuerzas	LOC_NCFS000
correo basura	LOC_NCFS000
correo no deseado	LOC_NCFS000
corriente y moliente	AQ0CS0
cortes generales	LOC_NCFP000
corte suprema	LOC_NCFS000
corteza cerebral	LOC_NCFS000
cosa juzgada	LOC_NCFS000
C. por A.	Y
C. P.	Y
cp.	Y
crecimiento de la población	LOC_NCMS000
crecimiento urbano	LOC_NCMS000
crec.	Y
crédito personal	LOC_NC
crisis económica	LOC_NC
cruz roja internacional	LOC_NCFS000
cruz roja	LOC_NCFS000
cta. cte.	Y
cta.	Y
Cte.	Y
cts.	Y
ctvo.	Y
ctv.	Y
cuanto antes	LOC_ADV
cubierta vegetal	LOC_NC
cuello uterino	LOC_NCMS000
cuenta de ahorro	LOC_NC
cuenta de pérdidas y ganancias	LOC_NC
cuenta de resultados	LOC_NC
cuerpo de bomberos	LOC_NC
cuerpo diplomático	LOC_NC
cuerpo docente	LOC_NC
cuerpo legislativo	LOC_NC
cuidado médico	LOC_NC
cultura clásica	LOC_NCFS000
cum laude	LOC_ADJ
cum laude	LOC_ADV
cum laude	LOC_AQ0CN0
curriculum vitae	LOC_ADV
curriculum vitae	NCMN000
curso académico	LOC_NC
curso intensivo	LOC_NC
c/u	Y
c/	Y
c.	Y
da capo	LOC_ADV
dado que	LOC_CS
dalái lama	NPMNSP0
daño cerebral	LOC_NC
daño material	LOC_NC
darse de alta	LOC_ADV
dato económico	LOC_NC
dato personal	LOC_NC
datos bancario	LOC_NC
D.ª	Y
dcha.	Y
dcho.	Y
d. C.	Y
d. de C.	Y
d. de J. C.	Y
de acá para allá	LOC_ADV
de acarreo	LOC_ADV
de acuerdo con	LOC_PREP
de a folio	LOC_ADV
de ahí que	LOC_CS
de al lado de	LOC_PREP
de alto copete	LOC_ADV
de alto coturno	LOC_ADV
de altos vuelos	LOC_ADV
de amplio espectro	LOC_ADV
de andar por casa	LOC_ADV
de anequín	LOC_ADV
de antemano	LOC_ADV
de aquí en adelante	LOC_ADV
de aquí para allí	LOC_ADV
de aquí que	LOC_CS
de armas tomar	LOC_ADV
de arrastre	LOC_ADV
de arte mayor	LOC_ADV
de arte menor	LOC_ADV
de aúpa	LOC_ADV
de a veras	LOC_ADV
de baja estofa	LOC_ADV
debajo de	LOC_PREP
de bajo vuelo	LOC_ADV
de balde	LOC_ADV
de ballesta	LOC_ADV
de barra a barra	LOC_ADV
debate parlamentario	LOC_NC
debido a	LOC_PREP
de bóbilis	LOC_ADV
de boca en boca	LOC_ADV
de bote en bote	LOC_ADV
de bracero	LOC_ADV
de bruces	LOC_ADV
de buena cepa	LOC_ADV
de buena familia	LOC_ADV
de buena fe	LOC_ADV
de buena gana	LOC_ADV
de buena ley	LOC_ADV
de buena ropa	LOC_ADV
de buenas a primeras	LOC_ADV
de buena voluntad	LOC_ADV
de buen efecto	LOC_ADV
de buen grado	LOC_ADV
de buen tono	LOC_ADV
de bureo	LOC_ADV
de cabo a rabo	LOC_ADV
de canto	LOC_ADV
de cañutillo	LOC_ADV
de cara a	LOC_PREP
de carrerilla	LOC_ADV
de carretilla	LOC_ADV
de cascabel gordo	LOC_ADV
de casquería	LOC_ADV
de chipén	LOC_ADV
de churro	LOC_ADV
de ciencia cierta	LOC_ADV
de circunvalación	LOC_ADV
declaración de guerra	LOC_NCFS000
declaración de principios	LOC_NCFS000
declaración jurada	LOC_NC
de coña	LOC_ADV
de consuno	LOC_ADV
de corredera	LOC_ADV
de cortos vuelos	LOC_ADV
decreto ley	LOC_NC
decreto ley	NCMS000
decretos leyes	NCMS000
de cuajo	LOC_ADV
de cualquier forma	LOC_ADV
de cuando en cuando	LOC_ADV
de cuelga	LOC_ADV
de cuenta y riesgo	LOC_ADV
de cuerpo presente	LOC_ADV
de cutio	LOC_ADV
de debajo de	LOC_PREP
de delante de	LOC_PREP
de dentro de	LOC_PREP
de detrás de	LOC_PREP
de día en día	LOC_ADV
de dientes afuera	LOC_ADV
de Dios abajo	LOC_ADV
de disparo	LOC_ADV
de doble filo	LOC_ADV
de dos en dos	LOC_ADV
de dos filos	LOC_ADV
de ensueño	LOC_ADV
de entonces acá	LOC_ADV
de entreguerras	LOC_ADJ
de estampía	LOC_ADV
de este lado de	LOC_PREP
de extranjis	LOC_ADV
de facto	LOC_ADV
de falondres	LOC_ADV
de fogueo	LOC_ADV
de fuera de	LOC_PREP
de golpe y porrazo	LOC_ADV
de grado en grado	LOC_ADV
de guagua	LOC_ADV
de guardarropía	LOC_ADV
de guillotina	LOC_ADV
de higos a brevas	LOC_ADV
de hoy en adelante	LOC_ADV
de hoy para mañana	LOC_ADV
de hoz y de coz	LOC_ADV
de ida y vuelta	LOC_ADV
de iure	LOC_ADV
de jure	LOC_ADV
de juro	LOC_ADV
de la cruz a la fecha	LOC_ADV
de lado a lado	LOC_ADV
de la mano de	LOC_PREP
de lance en lance	LOC_ADV
de la noche a la mañana	LOC_ADV
delante de Dios y de todo el	LOC_ADV
delante de	LOC_PREP
de la puñeta	LOC_ADV
de la zona de	LOC_PREP
delegación territorial	LOC_NC
de lengua en lengua	LOC_ADV
delirium tremens	NCMN000
delito doloso	LOC_NCMS000
de lo contrario	LOC_ADV
de lo lindo	LOC_ADV
del otro lado de	LOC_PREP
del otro lado	LOC_ADV
de lo vivo a lo pintado	LOC_ADV
del poder de	LOC_PREP
del primer voleo	LOC_ADV
del principio al fin	LOC_ADV
del revés	LOC_ADV
del tiempo de Maricastaña	LOC_ADJ
del tiempo de Maricastaña	LOC_ADV
del.	Y
de madrugada	LOC_ADV
de mal abrigo	LOC_ADV
de mala fe	LOC_ADV
de mala gana	LOC_ADV
de mala ley	LOC_ADV
de mal a mal	LOC_ADV
de mala manera	LOC_ADV
de mala muerte	LOC_ADV
de mala nota	LOC_ADV
de mal efecto	LOC_ADV
de mal en peor	LOC_ADV
de mal grado	LOC_ADV
de mal tono	LOC_ADV
de mal vivir	LOC_ADV
de mancomún	LOC_ADV
demanda agregada	LOC_NCFS000
demanda de empleo	LOC_NC
demandante de empleo	LOC_NC
de mano derecha	LOC_ADV
de mano en mano	LOC_ADV
de mano izquierda	LOC_ADV
de manos a boca	LOC_ADV
de marca mayor	LOC_ADV
de marras	LOC_ADV
de más marca	LOC_ADV
de matute	LOC_ADV
de media gala	LOC_ADV
de medio a medio	LOC_ADV
de medio lado	LOC_ADV
de medio ojo	LOC_ADV
de medio pie	LOC_ADV
de mentirijillas	LOC_ADV
de mil amores	LOC_ADV
de mil diablos	LOC_ADV
de mírame y no me toques	LOC_ADV
de miranda	LOC_ADV
de misa y olla	LOC_ADV
democracia participativa	LOC_NCFS000
de modo que	LOC_CS
de momio	LOC_ADV
de morondanga	LOC_ADV
de muchas campanillas	LOC_ADV
de muchas leguas	LOC_ADV
de mucho efecto	LOC_ADV
de mucho trote	LOC_ADV
de ninguna manera	LOC_ADV
denominación social	LOC_NCFS000
de nueva planta	LOC_ADV
de nuevo cuño	LOC_ADV
de nunca acabar	LOC_ADV
deo gracias	I
deo gracias	LOC_ADV
deo gracias	LOC_I
de oídas	LOC_ADV
de oque	LOC_ADV
de órdago	LOC_ADV
de oreja a oreja	LOC_ADV
de oro y azul	LOC_ADV
deo volente	LOC_ADV
Deo volente	LOC_ADV
de pacotilla	LOC_ADV
de padre y muy señor mío	LOC_ADV
de palabra en palabra	LOC_ADV
departamento de agricultura	LOC_NCMS000
departamento de educación	LOC_NCMS000
departamento de industria , comercio y turismo	LOC_NCMS000
departamento de justicia	LOC_NCMS000
departamento de medio ambiente	LOC_NCMS000
de pascuas a ramos	LOC_ADV
de pe a pa	LOC_ADV
de pega	LOC_ADV
de pelo en pecho	LOC_ADV
dependencia económica	LOC_NCFS000
de perdidos al río	LOC_ADV
de perilla	LOC_ADV
de perillas	LOC_ADV
de persona a persona	LOC_ADV
de pie de banco	LOC_ADV
de pies a cabeza	LOC_ADV
de pilón	LOC_ADV
de pitiminí	LOC_ADV
de pleno derecho	LOC_ADV
de poca monta	LOC_ADV
de poca ropa	LOC_ADV
de poco más o menos	LOC_ADV
de poco pelo	LOC_ADV
de poder a poder	LOC_ADV
de polo a polo	LOC_ADV
de pontifical	LOC_ADV
de popa a proa	LOC_ADV
de por junto	LOC_ADV
de por medio	LOC_ADV
de por sí	LOC_ADV
deporte de aventura	LOC_NC
deporte profesional	LOC_NCMS000
de por vida	LOC_ADV
de postín	LOC_ADV
de potencia en potencia	LOC_ADV
de primera clase	LOC_ADV
de primera intención	LOC_ADV
de primera línea	LOC_ADV
de prisa	LOC_ADV
de prisa y corriendo	LOC_ADV
de profundis	LOC_ADV
de pro	LOC_ADV
de propia minerva	LOC_ADV
de propio puño	LOC_ADV
depto.	Y
de puerta a puerta	LOC_ADV
de puerta en puerta	LOC_ADV
de puertas adentro	LOC_ADV
de puertas afuera	LOC_ADV
de puertos allende	LOC_ADV
de puertos aquende	LOC_ADV
de puño y letra	LOC_ADV
de punta a cabo	LOC_ADV
de punta a punta	LOC_ADV
de pura cepa	LOC_ADV
depuración de aguas	LOC_NCMS000
depuración de aguas residuales	LOC_NCMS000
de puta madre	LOC_ADV
de puta pena	LOC_ADV
de putifa	LOC_ADV
D. E. P.	Y
de quedo	LOC_ADV
de quita y pon	LOC_ADV
de rama en rama	LOC_ADV
de raro en raro	LOC_ADV
de rato en rato	LOC_ADV
de rebato	LOC_ADV
de rebote	LOC_ADV
derecho adquirido	LOC_NC
derecho a participar	LOC_NCMS000
derecho civil	LOC_NC
derecho de asociación	LOC_NCMS000
derecho de autodeterminación	LOC_NCMS000
derecho de familia	LOC_NCMS000
derecho de huelga	LOC_NCMS000
derecho del hombre	LOC_NC
derecho de petición	LOC_NCMS000
derecho de uso	LOC_NCMS000
derecho de voto	LOC_NCMS000
derecho fiscal	LOC_NCMS000
derecho fundamental	LOC_NC
derecho humano	LOC_NC
derecho individual	LOC_NCMS000
derecho nacional	LOC_NCMS000
derecho natural	LOC_NCMS000
derecho político	LOC_NC
derecho positivo	LOC_NCMS000
derecho privado	LOC_NCMS000
derecho público	LOC_NCMS000
derecho subjetivo	LOC_NCMS000
derecho tributario	LOC_NCMS000
de rechupete	LOC_ADV
de refilón	LOC_ADV
de relumbrón	LOC_ADV
de reojo	LOC_ADV
de repelón	LOC_ADV
de repente	LOC_ADV
de repuesto	LOC_ADV
de reserva	LOC_ADV
de resultas	LOC_ADV
de retrocarga	LOC_ADV
de revuelo	LOC_ADV
de rodilla en rodilla	LOC_ADV
de rompe y rasga	LOC_ADV
de rondón	LOC_ADV
desarrollo de la personalidad	LOC_NCMS000
desarrollo económico	LOC_NCMS000
desarrollo rural	LOC_NCMS000
desarrollo urbano	LOC_NCMS000
desastre ecológico	LOC_NC
desastre natural	LOC_NC
descarga eléctrica	LOC_NC
desct.º	Y
desde cero	LOC_ADV
desde el momento en que	LOC_CS
desde luego	LOC_ADV
desde niño	LOC_ADV
desde que el mundo es mundo	LOC_ADV
de seguida	LOC_ADV
de segunda mano	LOC_ADV
de sentido común	LOC_ADV
de sobra	LOC_ADV
de sobresalto	LOC_ADV
de so capa	LOC_ADV
de sol a sol	LOC_ADV
de soslayo	LOC_ADV
de suerte que	LOC_CS
de tal manera que	LOC_CS
de tapadillo	LOC_ADV
de tarde en tarde	LOC_ADV
de tiempo en tiempo	LOC_ADV
de tiento en tiento	LOC_ADV
de todas maneras	LOC_ADV
de todas todas	LOC_ADV
de todo corazón	LOC_ADV
de todo en todo	LOC_ADV
de todo punto	LOC_ADV
de todos los diablos	LOC_ADV
de todos modos	LOC_ADV
detrás de	LOC_PREP
de través	LOC_ADV
de trazo continuo	LOC_ADV
de trecho en trecho	LOC_ADV
de tres al cuarto	LOC_ADV
de tú a tú	LOC_ADV
de ultratumba	LOC_ADV
de una manera o de otra	LOC_ADV
de una sentada	LOC_ADV
de una tacada	LOC_ADV
de una tirada	LOC_ADV
de una vez para siempre	LOC_ADV
de un día a otro	LOC_ADV
de un jalón	LOC_ADV
de un lado a otro	LOC_ADV
de un lado para otro	LOC_ADV
de uno en uno	LOC_ADV
de un plumazo	LOC_ADV
de un primer voleo	LOC_ADV
de un tirón	LOC_ADV
deus ex machina	NCMN000
de uso externo	LOC_ADV
de uvas a peras	LOC_ADV
de vértigo	LOC_ADV
de vez en cuando	LOC_ADV
de vía estrecha	LOC_ADV
de visu	LOC_ADV
de viva voz	LOC_ADV
de volatería	LOC_ADV
d/f	Y
D. F.	Y
día de acción de gracias	LOC_NCMS000
día de descanso	LOC_NC
día de fiesta	LOC_NC
diagnóstico clínico	LOC_NC
diagnóstico médico	LOC_NC
diagnóstico precoz	LOC_NC
diag.	Y
diario oficial de la unión europea	LOC_NCMS000
dibujo animado	LOC_NC
dicc.	Y
dictadura militar	LOC_NC
dies irae	NCMS000
dieta equilibrada	LOC_NC
dietética y nutrición	LOC_NCMS000
dignidad humana	LOC_NCFS000
dióxido de azufre	LOC_NCFS000
dióxido de carbono	LOC_NCFS000
Dir.	NCMS000
Dir.ª	NCFS000
dirección administrativa	LOC_NCFS000
dirección a	LOC_PREP
dirección del viento	LOC_NCFS000
dirección de recursos humanos	LOC_NCFS000
dirección general de carreteras	LOC_NCFS000
dirección general de cultura	LOC_NCFS000
dirección general de los registros y del notariado	LOC_NCFS000
dirección general de seguros	LOC_NCFS000
dirección general de servicios	LOC_NCFS000
dirección general de tráfico	LOC_NCFS000
dirección general	LOC_NCFS000
dirección ip	LOC_NCFS000
dirección url	LOC_NCFS000
director adjunto	LOC_NC
director administrativo	LOC_NC
director artístico	LOC_NC
director de fotografía	LOC_NC
director de orquesta	LOC_NC
director general	LOC_NC
director gerente	LOC_NC
directorio raíz	LOC_NCFS000
director técnico	LOC_NC
Dir.	Y
disc jockey	LOC_NCFS000
diseño asistido por ordenador	LOC_NCMS000
diseño editorial	LOC_NCMS000
diseño industrial	LOC_NCMS000
disfunción eréctil	LOC_NC
disposición legal	LOC_NC
distribución espacial	LOC_NCFS000
distribución geográfica	LOC_NCFS000
distribución normal	LOC_NCFS000
distrito electoral	LOC_NC
diversidad biológica	LOC_NCFS000
división de poderes	LOC_NCFS000
d. J. C.	Y
D. L.	Y
D. m.	Y
Dña.	Y
doble imposición	LOC_NCCS000
doble nacionalidad	LOC_NCCS000
doctor en derecho	LOC_NC
documentación administrativa	LOC_NCFS000
documento de identidad	LOC_NC
documento html	LOC_NCMS000
doc.	Y
dolor de cabeza	LOC_NC
domiciliación bancaria	LOC_NC
domicilio legal	LOC_NCMS000
domicilio social	LOC_NCMS000
dotación presupuestaria	LOC_NC
do ut des	LOC_ADV
dpto.	Y
D. P.	Y
Dr.	NCMS000
Dr.ª	NCFS000
Dra.	NCFS000
droga ilícita	LOC_NC
dto.	Y
dupdo.	Y
duración del contrato	LOC_NCFS000
duty free	LOC_ADJ
duty free	LOC_AQ0CN0
d/v	Y
D.	Y
Dña.	NCFS000
eclipse total	LOC_NC
economía aplicada	LOC_NCFS000
economía de escala	LOC_NC
economía de la salud	LOC_NCFS000
economía doméstica	LOC_NCFS000
economía española	LOC_NCFS000
economía familiar	LOC_NCFS000
economía general	LOC_NCFS000
economía informal	LOC_NCFS000
economía internacional	LOC_NCFS000
economía mixta	LOC_NCFS000
economía mundial	LOC_NCFS000
economía nacional	LOC_NCFS000
economía política	LOC_NCFS000
economía regional	LOC_NCFS000
economía social	LOC_NCFS000
e/c	Y
e. c.	Y
edad adulta	LOC_NCFS000
edad de jubilación	LOC_NCFS000
edad de oro	LOC_NCFS000
edad escolar	LOC_NCFS000
edad media	LOC_NC
edición limitada	LOC_NC
edificio central	LOC_NC
edificio principal	LOC_NC
edit.	Y
edo.	Y
educación ambiental	LOC_NCFS000
educación artística	LOC_NCFS000
educación de adultos	LOC_NCFS000
educación escolar	LOC_NCFS000
educación formal	LOC_NCFS000
educación general básica	LOC_NCFS000
educación infantil	LOC_NCFS000
educación infantil y primaria	LOC_NCFS000
educación intercultural	LOC_NCFS000
educación obligatoria	LOC_NCFS000
educación para el desarrollo	LOC_NCFS000
educación para la salud	LOC_NCFS000
educación preescolar	LOC_NCFS000
educación primaria	LOC_NCFS000
educación religiosa	LOC_NCFS000
educación sanitaria	LOC_NCFS000
educación secundaria	LOC_NCFS000
educación secundaria obligatoria	LOC_NCFS000
educación sexual	LOC_NCFS000
educación vial	LOC_NCFS000
ed.	Y
EE. UU.	NPMPG00
efecto directo	LOC_NC
efecto especial	LOC_NC
ef.	Y
ejecución de sentencia	LOC_NCFS000
eje principal	LOC_NC
ejercicio económico	LOC_NC
ejercicio físico	LOC_NC
ejército de liberación	LOC_NCMS000
ejército de liberación nacional	LOC_NCMS000
ejército de tierra	LOC_NCMS000
ejército nacional	LOC_NCMS000
ejército popular	LOC_NCMS000
ejército zapatista de liberación nacional	LOC_NCMS000
eje y	LOC_NCMS000
ej.	Y
el acabose	NCMS000
elecciones al parlamento europeo	LOC_NCFP000
elecciones libres	LOC_NCFP000
elecciones parlamentarias	LOC_NCFP000
elección presidencial	LOC_NCFS000
El Escorial	NPMSG00
eliminación de residuos	LOC_NCFS000
Em.ª	Y
emergencia social	LOC_NC
emisión de bonos	LOC_NC
emisión de gases	LOC_NC
Emmo.	Y
empleo estable	LOC_NC
empresa comercial	LOC_NC
empresa constructora	LOC_NC
empresa de servicios	LOC_NC
empresa de transporte	LOC_NC
empresa estatal	LOC_NC
empresa familiar	LOC_NC
empresa industrial	LOC_NC
empresa multinacional	LOC_NC
empresa privada	LOC_NC
empresa pública	LOC_NC
en agraz	LOC_ADV
en aquel entonces	LOC_ADV
en aras de	LOC_PREP
en atención a	LOC_PREP
en babia	LOC_ADV
en batería	LOC_ADV
en berlina	LOC_ADV
en buena lid	LOC_ADV
en buenos términos	LOC_ADV
en busca de	LOC_PREP
en calidad de	LOC_PREP
en cambio de	LOC_PREP
en caso de	LOC_PREP
en caso de que	LOC_CS
encefalopatía espongiforme bovina	LOC_NCFS000
en cierto modo	LOC_ADV
encima de	LOC_PREP
en círculo	LOC_ADV
en compañía de	LOC_PREP
en compensación de	LOC_PREP
en coña	LOC_ADV
en concepto de	LOC_PREP
en consecuencia	LOC_ADV
en contorno	LOC_ADV
en contracambio	LOC_ADV
en contra de	LOC_PREP
en cuanto a	LOC_PREP
en cuanto que	LOC_CS
en cuclillas	LOC_ADV
en cuerpo y alma	LOC_ADV
encuesta de opinión	LOC_NC
en cuestión de	LOC_PREP
en defecto de	LOC_PREP
en demanda de	LOC_PREP
en demasía	LOC_ADV
en derredor de	LOC_PREP
en derredor	LOC_ADV
en desbandada	LOC_ADV
en descargo	LOC_ADV
en desquite	LOC_ADV
en detalle	LOC_ADV
en diferido	LOC_ADV
en Dios y en conciencia	LOC_ADV
en dirección a	LOC_PREP
endocrinología y nutrición	LOC_NCFS000
en el centro de	LOC_PREP
en el entorno de	LOC_PREP
en el interior de	LOC_PREP
en el otro lado de	LOC_PREP
en el plazo de	LOC_PREP
en el puesto de	LOC_PREP
en el supuesto que	LOC_CS
en entredicho	LOC_ADV
energía eólica	LOC_NCFS000
energía térmica	LOC_NCFS000
en espera de	LOC_PREP
en este mismo instante	LOC_ADV
en evitación de	LOC_PREP
en favor de	LOC_PREP
enfermedad grave	LOC_NC
enfermedad profesional	LOC_NC
en fiado	LOC_ADV
en fila india	LOC_ADV
en fin de cuentas	LOC_ADV
en franquía	LOC_ADV
enfrente de	LOC_PREP
en gracia a	LOC_PREP
en gran manera	LOC_ADV
en gran medida	LOC_ADV
en guisa de	LOC_PREP
en honor a la verdad	LOC_ADV
en horre	LOC_ADV
en interés	LOC_ADV
en jamás de los jamases	LOC_ADV
en junto	LOC_ADV
en la línea de	LOC_PREP
en la necesidad de	LOC_PREP
en las cercanías de	LOC_PREP
en las proximidades de	LOC_PREP
en la temporada de	LOC_PREP
en la zona de	LOC_PREP
en limpio	LOC_ADV
en línea	LOC_ADV
en líneas generales	LOC_ADV
en lo concerniente a	LOC_PREP
en lontananza	LOC_ADV
en los buenos tiempos	LOC_ADV
en lo sucesivo	LOC_ADV
en lugar de	LOC_PREP
en lugar de que	LOC_CS
en mala hora	LOC_ADV
en mangas de camisa	LOC_ADV
en manos de	LOC_PREP
en materia de	LOC_PREP
en medio de	LOC_PREP
en memoria de	LOC_PREP
en menos de	LOC_PREP
en miniatura	LOC_ADV
en mitad de	LOC_PREP
en modo alguno	LOC_ADV
en obligación de	LOC_PREP
en obsequio a	LOC_PREP
en obsequio de	LOC_PREP
en oferta	LOC_ADV
en oposición a	LOC_PREP
en orden a	LOC_PREP
en paños menores	LOC_ADV
en paralelo	LOC_ADV
en parte por	LOC_PREP
en partes iguales	LOC_ADV
en pelota picada	LOC_ADV
en pie de guerra	LOC_ADV
en plan de	LOC_PREP
en plantilla	LOC_ADV
en pocas palabras	LOC_ADV
en porretas	LOC_ADV
en pos de	LOC_PREP
en prenda	LOC_ADV
en primicia	LOC_ADV
en procura	LOC_ADV
en pro de	LOC_PREP
en prueba de	LOC_PREP
en punto de caramelo	LOC_ADV
en puridad	LOC_ADV
en rama	LOC_ADV
en razón de	LOC_PREP
en recuerdo de	LOC_PREP
en rededor	LOC_ADV
en remojo	LOC_ADV
en representación de	LOC_PREP
en resumidas cuentas	LOC_ADV
en ristre	LOC_ADV
en salvo	LOC_ADV
ensayo clínico	LOC_NC
en seguida	LOC_ADV
en señal de	LOC_PREP
enseñanza básica	LOC_NCFS000
enseñanza de idiomas	LOC_NCFS000
enseñanza media	LOC_NCFS000
en sordina	LOC_ADV
en su defecto	LOC_ADV
en tándem	LOC_ADV
en tanto que	LOC_CS
ente público	LOC_NCFS000
entidad gestora	LOC_NCFS000
entidad pública	LOC_NCFS000
en tiempo de	LOC_PREP
en tiempo diferido	LOC_ADV
en tiempo real	LOC_ADV
en tiempo récord	LOC_ADV
en tiempo y forma	LOC_ADV
entlo.	Y
en toda la extensión de la palabra	LOC_ADV
en toda regla	LOC_ADV
en toda tierra de garbanzos	LOC_ADV
en todo caso	LOC_ADV
en todo lo descubierto	LOC_ADV
en torno a	LOC_PREP
en torno de	LOC_PREP
entorno de red	LOC_NCMS000
entorno social	LOC_NCMS000
en touche	LOC_ADV
entrada gratuita	LOC_NCFS000
entrega de premios	LOC_NC
entre la espada y la pared	LOC_ADV
entre la vida y la muerte	LOC_ADV
entrenamiento físico	LOC_NCMS000
entre pecho y espalda	LOC_ADV
entre que	LOC_CS
entre tanto que	LOC_CS
en tromba	LOC_ADV
en un abrir y cerrar de ojos	LOC_ADV
en un decir amén	LOC_ADV
en un pis-pas	LOC_ADV
en un pispás	LOC_ADV
en un santiamén	LOC_ADV
en un tris	LOC_ADV
en vez de	LOC_PREP
en vez de que	LOC_CS
en vías de	LOC_PREP
en vilo	LOC_ADV
en virtud de	LOC_PREP
en vista de	LOC_PREP
en vista de que	LOC_CS
en volandas	LOC_ADV
en zigzag	LOC_ADV
e. p. d.	Y
e. p. m.	Y
equilibrio ecológico	LOC_NCMS000
equipo de fútbol	LOC_NC
equipo de protección	LOC_NC
equipo de sonido	LOC_NC
equipo directivo	LOC_NC
equipo docente	LOC_NC
equipo informático	LOC_NC
equipo nacional	LOC_NC
erario público	LOC_NCMS000
escala de valores	LOC_NC
esclerosis múltiple	LOC_NCMS000
escuela de arte	LOC_NC
escuela de bellas artes	LOC_NC
escuela de música	LOC_NC
escuela oficial de idiomas	LOC_NCFS000
escuela rural	LOC_NC
escuela taller	LOC_NC
es hablar por demás	LOC_ADV
e. s. m.	Y
espacio económico europeo	LOC_NCMS000
espacio en blanco	LOC_NC
especie humana	LOC_NCFS000
esperando a	LOC_PREP
estabilidad económica	LOC_NCFS000
estabilidad política	LOC_NCFS000
estación de autobús	LOC_NC
estación de ferrocarril	LOC_NC
estación de tren	LOC_NC
estación meteorológica	LOC_NC
estadio olímpico	LOC_NC
estadística descriptiva	LOC_NCFS000
estado anímico	LOC_NCMS000
estado del bienestar	LOC_NCMS000
estado democrático	LOC_NC
estado de salud	LOC_NCMS000
estado emocional	LOC_NCMS000
estado federal	LOC_NC
estado independiente	LOC_NC
estado miembro de la unión europea	LOC_NC
estado nacional	LOC_NC
estado sólido	LOC_NCMS000
estatutos sociales	LOC_NCMP000
estructura de datos	LOC_NC
estructura económica	LOC_NCFS000
estructura familiar	LOC_NC
estructura jerárquica	LOC_NCFS000
estructura social	LOC_NCFS000
estudio de grabación	LOC_NC
estudio de impacto	LOC_NC
estudio económico	LOC_NC
estudios empresariales	LOC_NCMP000
et ál.	Y
etc.	Y
evaluación continua	LOC_NC
evaluación del impacto ambiental	LOC_NC
evaluación del riesgo	LOC_NC
evaluación externa	LOC_NC
evidencia científica	LOC_NC
ex abrupto	LOC_ADV
ex aequo	LOC_ADV
ex ante	LOC_ADV
ex ante	LOC_AQ0CN0
ex cátedra	LOC_ADV
ex cathedra	LOC_ADV
ex cáthedra	LOC_ADV
Exc.ª	Y
exceptio veritatis	LOC_ADV
excepto que	LOC_CS
exceso de velocidad	LOC_NC
excl.	Y
Excma.	Y
Excmo.	Y
expansión económica	LOC_NCFS000
expediente disciplinario	LOC_NC
explotación agrícola	LOC_NC
exposición itinerante	LOC_NC
exposición permanente	LOC_NC
ex post	LOC_ADV
ex post	LOC_AQ0CN0
expresión artística	LOC_NCFS000
expresión escrita	LOC_NCFS000
expresión oral	LOC_NCFS000
expresión plástica	LOC_NCFS000
ex profeso	LOC_ADV
ex testamento	LOC_ADV
extrema derecha	LOC_NCFS000
e/	Y
factor ambiental	LOC_NC
factor de riesgo	LOC_NC
facultad de bellas artes	LOC_NCFS000
facultad de derecho	LOC_NCFS000
facultad de psicología	LOC_NCFS000
fal Fh s	LOC_NCFS000
falso testimonio	LOC_NC
farmacología clínica	LOC_NCFS000
fasc.	Y
fata morgana	NCFS000
fauna marina	LOC_NCFS000
f.ª	Y
fca.	Y
F. C.	Y
Fdo.	Y
fecha de cierre	LOC_NC
fecha de emisión	LOC_NC
fecha de solicitud	LOC_NC
fecha límite	LOC_NC
fecha tope	LOC_NC
fe cristiana	LOC_NCFS000
féc.	Y
federación nacional	LOC_NC
FF. AA.	Y
ficha técnica	LOC_NC
fichero de datos	LOC_NC
figura jurídica	LOC_NC
fig.	Y
filología clásica	LOC_NCFS000
filosofía de la ciencia	LOC_NCFS000
filosofía del derecho	LOC_NCFS000
filosofía política	LOC_NCFS000
final feliz	LOC_NC
fiscal jefe	LOC_NC
física aplicada	LOC_NCFS000
física nuclear	LOC_NCFS000
física teórica	LOC_NCFS000
flujo de aire	LOC_NCFS000
flujo de caja	LOC_NCFS000
flujo de datos	LOC_NCFS000
flujo de fondos	LOC_NCFS000
flujo de información	LOC_NCFS000
foie gras	NCMS000
fol.	Y
fondo de garantía	LOC_NC
fondo de pensiones	LOC_NC
fondo documental	LOC_NC
fondo europeo de desarrollo	LOC_NCMS000
fondo monetario internacional	LOC_NCMS000
fondo social europeo	LOC_NCMS000
formación humana	LOC_NCFS000
formación ocupacional	LOC_NCFS000
formación profesional específica	LOC_NCFS000
formación profesional ocupacional	LOC_NCFS000
forma gráfica	LOC_NC
formato html	LOC_NCFS000
fosa nasal	LOC_NC
fotografía aérea	LOC_NCFS000
fox terrier	NCMN000
f.º	Y
frame relay	LOC_NCFS000
fra.	Y
frecuencia cardiaca	LOC_NC
free lance	NCMN000
frente nacional	LOC_NCFS000
frente popular	LOC_NCFS000
fruta fresca	LOC_NCFS000
fruto seco	LOC_NC
Fr.	Y
ft3 Fh min	LOC_NCFS000
ft3 Fh s	LOC_NCFS000
ft Fh h	LOC_NCFS000
ft Fh min	LOC_NCFS000
ft Fh s2	LOC_NCFS000
ft Fh s	LOC_NCFS000
fuente de alimentación	LOC_NC
fuente de datos	LOC_NC
fuente de energía	LOC_NC
fuente de financiación	LOC_NC
fuente de luz	LOC_NC
fuera de que	LOC_CS
fuerza física	LOC_NCFS000
fuerza militar	LOC_NCFS000
fuerzas de ocupación	LOC_NCFP000
fuerzas de seguridad	LOC_NCFP000
fuerzas y cuerpos de seguridad	LOC_NCFP000
fuga de capitales	LOC_NCFS000
full time	LOC_ADV
full time	LOC_AQ0CN0
función administrativa	LOC_NC
fundamento jurídico	LOC_NC
fundamentos de derecho	LOC_NCMP000
fútbol base	LOC_NCMS000
f.	Y
gabinete técnico	LOC_NC
galería comercial	LOC_NC
gal Fh ac Fh d	LOC_NCFS000
gal Fh cap Fh d	LOC_NCFS000
gal Fh d	LOC_NCFS000
gal Fh ft2 d	LOC_NCFS000
gal Fh ft2 Fh min	LOC_NCFS000
gal Fh ft2	LOC_NCFS000
gal Fh h	LOC_NCFS000
gal Fh min	LOC_NCFS000
galón acre Fh día	LOC_NC
galón acre por día	LOC_NC
galón cápita Fh día	LOC_NC
galón cápita por día	LOC_NC
galón día	LOC_NC
galón Fh acre día	LOC_NC
galón Fh acre Fh día	LOC_NC
galón Fh acre por día	LOC_NC
galón Fh cápita día	LOC_NC
galón Fh cápita Fh día	LOC_NC
galón Fh cápita por día	LOC_NC
galón Fh día	LOC_NC
galón Fh hora	LOC_NC
galón Fh minuto	LOC_NC
galón Fh pie cuadrado día	LOC_NC
galón Fh pie cuadrado Fh día	LOC_NC
galón Fh pie cuadrado Fh minuto	LOC_NC
galón Fh pie cuadrado	LOC_NC
galón Fh pie cuadrado minuto	LOC_NC
galón Fh pie cuadrado por día	LOC_NC
galón Fh pie cuadrado por minuto	LOC_NC
galón Fh segundo	LOC_NC
galón hora	LOC_NC
galón minuto	LOC_NC
galón per cápita día	LOC_NC
galón per cápita Fh día	LOC_NC
galón per cápita por día	LOC_NC
galón pie cuadrado Fh día	LOC_NC
galón pie cuadrado Fh minuto	LOC_NC
galón pie cuadrado por día	LOC_NC
galón pie cuadrado por minuto	LOC_NC
galón por acre día	LOC_NC
galón por acre Fh día	LOC_NC
galón por acre por día	LOC_NC
galón por acre y día	LOC_NC
galón por cápita día	LOC_NC
galón por cápita Fh día	LOC_NC
galón por cápita por día	LOC_NC
galón por día	LOC_NC
galón por hora	LOC_NC
galón por minuto	LOC_NC
galón por pie cuadrado día	LOC_NC
galón por pie cuadrado Fh día	LOC_NC
galón por pie cuadrado Fh minuto	LOC_NC
galón por pie cuadrado	LOC_NC
galón por pie cuadrado minuto	LOC_NC
galón por pie cuadrado por día	LOC_NC
galón por pie cuadrado por minuto	LOC_NC
galón por pie cuadrado y día	LOC_NC
galón por pie cuadrado y minuto	LOC_NC
galón por segundo	LOC_NC
galón segundo	LOC_NC
gama de productos	LOC_NC
ganancia neta	LOC_NC
garantía constitucional	LOC_NCFS000
garantía hipotecaria	LOC_NCFS000
gastos corrientes	LOC_NCMP000
gastos de administración	LOC_NCMP000
gastos de capital	LOC_NCMP000
gastos de funcionamiento	LOC_NCMP000
gastos de gestión	LOC_NCMP000
gastos de mantenimiento	LOC_NCMP000
gastos de personal	LOC_NCMP000
gastos de transporte	LOC_NCMP000
gastos de viaje	LOC_NCMP000
gastos fijos	LOC_NCMP000
gastos financieros	LOC_NCMP000
gastos públicos	LOC_NCMP000
gastos sociales	LOC_NCMP000
Gdor.ª	Y
Gdora.	Y
Gdor.	Y
género literario	LOC_NC
Gengis Kan	NPMNSP0
geografía física	LOC_NCFS000
geografía humana	LOC_NCFS000
geometría analítica	LOC_NCFS000
gestión administrativa	LOC_NCFS000
gestión clínica	LOC_NCFS000
gestión de datos	LOC_NCFS000
gestión de la empresa	LOC_NCFS000
gestión de personal	LOC_NCFS000
gestión económica	LOC_NCFS000
gestión educativa	LOC_NCFS000
gestión empresarial	LOC_NCFS000
gestión interna	LOC_NCFS000
gestión medioambiental	LOC_NCFS000
gestión sanitaria	LOC_NCFS000
gestión urbanística	LOC_NCFS000
g Fh l	LOC_NCMP000
g Fh m3	LOC_NCMP000
gimnasia artística	LOC_NCFS000
giro postal	LOC_NC
globalización de la economía	LOC_NCFS000
Gloria Patri	NCMN000
gobierno central	LOC_NCMS000
gobierno civil	LOC_NCMS000
gobierno constitucional	LOC_NCMS000
gobierno federal	LOC_NCMS000
gobierno local	LOC_NCMS000
gobierno militar	LOC_NCMS000
gobierno provisional	LOC_NCMS000
gobierno revolucionario	LOC_NCMS000
Gob.	Y
golpe militar	LOC_NC
g/p	Y
g. p.	Y
gracia de dios	LOC_NCFS000
gracias a	LOC_PREP
gracias al que	LOC_CS
gracias a que	LOC_CS
grado celsius	LOC_NC
grado centígrado	LOC_NC
grado de madurez	LOC_NCMS000
grado farenheit	LOC_NC
grado kelvin	LOC_NC
Gral.	Y
gramo Fh litro	LOC_NC
gramo Fh metro cúbico	LOC_NC
gramo por litro	LOC_NC
gramo por metro cúbico	LOC_NC
gratis et amore	LOC_ADV
gripe aviar	LOC_NCFS000
grosso modo	LOC_ADV
grupo de edad	LOC_NC
grupo de empresas	LOC_NC
grupo de noticias	LOC_NC
grupo de trabajo	LOC_NC
grupo social	LOC_NC
guardería infantil	LOC_NC
guardia civil	LOC_NC
guardia nacional	LOC_NC
guerra civil española	LOC_NCFS000
guerra fría	LOC_NC
guerra mundial	LOC_NC
guía de turismo	LOC_NC
guía didáctica	LOC_NC
g. v.	Y
habeas corpus	NCMN000
hab Fh km	LOC_NCFS000
habitación doble	LOC_NC
habitación individual	LOC_NC
habitante Fh km2	LOC_NC
habitante Fh kms2	LOC_NC
habitante por kilómetro cuadrado	LOC_NC
habitante por km2	LOC_NC
hábito alimentario	LOC_NC
hacia mediados de	LOC_PREP
hacienda pública	LOC_NCFS000
hasta cierto punto	LOC_ADV
hasta cuando	LOC_CS
hasta más ver	LOC_ADV
hasta tanto que	LOC_CS
heavy metal	AQ0CN0
hecho imponible	LOC_NCMS000
hechos de los apóstoles	LOC_NCMP000
herramientas de gestión	LOC_NCFP000
hic et nunc	LOC_ADV
high tech	LOC_ADJ
high tech	LOC_AQ0CN0
higiene bucal	LOC_NCFP000
hijo pródigo	LOC_NC
hipótesis de trabajo	LOC_NCFN000
historia clínica	LOC_NC
historia de la educación	LOC_NCFS000
historia de la filosofía	LOC_NCFS000
historia del arte	LOC_NCFS000
historia económica	LOC_NCFS000
Hna.	Y
Hno.	Y
hoja de papel	LOC_NC
hoja informativa	LOC_NC
Hong Kong	NPCSG00
honoris causa	LOC_ADJ
honoris causa	LOC_AQ0CN0
horario de atención al público	LOC_NCMS000
horario de clases	LOC_NCMS000
horario de mañana	LOC_NCMS000
horario de verano	LOC_NCMS000
horario laboral	LOC_NCMS000
horas de oficina	LOC_NCFP000
horas de sol	LOC_NCFP000
horas hábiles	LOC_NCFP000
horno microondas	LOC_NC
horror vacui	NCMS000
hospital general	LOC_NCMS000
hospital infantil	LOC_NC
huella digital	LOC_NC
humanidades y ciencias sociales	LOC_NCFP000
humedad relativa	LOC_NCFS000
H.	Y
ibíd.	Y
ib.	Y
id. de usuario	LOC_NCMS000
ídem de ídem	LOC_ADV
identidad nacional	LOC_NC
identidad sexual	LOC_NCFS000
íd.	Y
i. e.	Y
igl.ª	Y
iglesia anglicana	LOC_NCFS000
iglesia católica	LOC_NCFS000
iglesia evangélica	LOC_NCFS000
iglesia ortodoxa	LOC_NCFS000
iglesia universal	LOC_NCFS000
igualdad de derechos	LOC_NCFS000
igualdad de oportunidades	LOC_NCFS000
igualdad entre hombres y mujeres	LOC_NCFS000
igualdad social	LOC_NCFS000
Ilma.	Y
Ilmo.	Y
Iltre.	Y
Il.	Y
imagen de marca	LOC_NCFS000
imagen personal	LOC_NCFS000
impacto ambiental	LOC_NC
impacto medioambiental	LOC_NC
impacto visual	LOC_NC
imperio de la ley	LOC_NCMS000
impreso de solicitud	LOC_NC
impr.	Y
impto.	Y
impuesto de sociedades	LOC_NCMS000
impuesto sobre actividades económicas	LOC_NCMS000
impuesto sobre bienes inmuebles	LOC_NCMS000
impuesto sobre el valor añadido	LOC_NCMS000
impuesto sobre la renta de las personas físicas	LOC_NCMS000
impuesto sobre la renta	LOC_NCMS000
impuesto sobre sociedades	LOC_NCMS000
impuesto sobre transmisiones patrimoniales	LOC_NCMS000
imp.	Y
in absentia	LOC_ADV
in aeternum	LOC_ADV
in albis	LOC_ADV
in anima vili	LOC_ADV
in ánima vili	LOC_ADV
in articulo mortis	LOC_ADV
in artículo mortis	LOC_ADV
incapacidad laboral	LOC_NCFS000
incapacidad permanente	LOC_NCFS000
incapacidad temporal	LOC_NCFS000
incl.	Y
incontinencia urinaria	LOC_NCFS000
incremento salarial	LOC_NC
in crescendo	LOC_ADV
índice de desarrollo humano	LOC_NCMS000
índice de precios al consumo	LOC_NCMS000
industria nacional	LOC_NCFS000
industria química	LOC_NCFS000
in extenso	LOC_ADV
in extremis	LOC_ADV
in Fh s2	LOC_NCFS000
in fieri	LOC_ADV
influencia política	LOC_NCFS000
información adicional	LOC_NCFS000
información general	LOC_NCFS000
información genética	LOC_NCFS000
información tecnológica	LOC_NCFS000
información turística	LOC_NCFS000
informática de gestión	LOC_NCFS000
informe de auditoría	LOC_NC
informe de evaluación	LOC_NC
informe de gestión	LOC_NC
in fraganti	LOC_ADV
ingeniería química	LOC_NCMS000
ingeniero agrónomo	LOC_NC
ingeniero químico	LOC_NC
ingeniero técnico agrícola	LOC_NC
Ing.	Y
iniciativa legislativa	LOC_NC
in illo tempore	LOC_ADV
in illo témpore	LOC_ADV
inmediatamente después de	LOC_PREP
in memóriam	LOC_ADV
in pártibus infidélium	LOC_ADV
in partibus	LOC_ADV
in partibus	LOC_AQ0CN0
in pectore	LOC_ADV
in péctore	LOC_ADV
in perpétuum	LOC_ADV
in promptu	LOC_ADV
in púribus	LOC_ADV
in situ	LOC_ADV
in sólidum	LOC_ADV
inspector general	LOC_NC
instituto nacional de empleo	LOC_NCMS000
instituto nacional de la salud	LOC_NCMS000
instituto nacional de la seguridad social	LOC_NCMS000
instituto nacional de meteorología	LOC_NCMS000
instrucciones de uso	LOC_NCFP000
instrumento musical	LOC_NC
Inst.	Y
integración económica	LOC_NCFS000
integración social	LOC_NCFS000
inteligencia humana	LOC_NCFS000
interacción social	LOC_NCFS000
intercambio de datos	LOC_NCMS000
interés social	LOC_NCMS000
interfaz de usuario	LOC_NC
inter nos	LOC_ADV
interposita persona	LOC_ADV
intervalo de tiempo	LOC_NC
intervención quirúrgica	LOC_NC
inter vivos	LOC_ADV
investigación clínica	LOC_NCFS000
invita Minerva	LOC_ADV
in vitro	LOC_ADV
in vitro	LOC_AQ0CN0
in vivo	LOC_ADV
in vivo	LOC_AQ0CN0
ipso facto	LOC_ADV
ipso iure	LOC_ADV
ipso jure	LOC_ADV
Islas Solomon	NPFPG00
Italo Calvino	NPMSSP0
iuris et de iure	LOC_ADV
I.	Y
izda.	Y
izdo.	Y
izqda.	Y
izqdo.	Y
izq.	Y
jamás de los jamases	LOC_ADV
jamás por jamás	LOC_ADV
J. C.	Y
jefe de gabinete	LOC_NC
jefe de proyecto	LOC_NC
jefe de seguridad	LOC_NC
jefe de unidad	LOC_NC
jefe militar	LOC_NC
jet lag	NCMS000
jet set	NCFS000
J Fh K	LOC_NCFS000
Jhs.	Y
JJ. OO.	Y
joule Fh grado kelvin	LOC_NC
joule Fh kelvin	LOC_NC
joule Fh K	LOC_NC
joule por grado kelvin	LOC_NC
joule por kelvin	LOC_NC
jubilación anticipada	LOC_NC
juego de mesa	LOC_NC
juegos olímpicos	LOC_NCMP000
juicio oral	LOC_NC
junta general de accionistas	LOC_NCFS000
junta militar	LOC_NCFS000
junto a	LOC_PREP
junto con	LOC_PREP
jurisdicción contencioso-administrativa	LOC_NCFS000
jurisdicción ordinaria	LOC_NCFS000
jurisdicción penal	LOC_NCFS000
juro a bríos	LOC_ADV
justicia ordinaria	LOC_NCFS000
justicia social	LOC_NCFS000
kg Fh cm2	LOC_NCMP000
kg Fh m2	LOC_NCMP000
kg Fh m3	LOC_NCMP000
kg Fh s	LOC_NCFS000
kilogramo Fh centímetro cuadrado	LOC_NC
kilogramo Fh metro cuadrado	LOC_NC
kilogramo Fh metro cúbico	LOC_NC
kilogramo Fh segundo	LOC_NC
kilogramo por centímetro cuadrado	LOC_NC
kilogramo por metro cuadrado	LOC_NC
kilogramo por metro cúbico	LOC_NC
kilogramo por segundo	LOC_NC
kilómetro cuadrado	LOC_NC
kilómetro Fh h Fh s	LOC_NC
kilómetro Fh h	LOC_NC
kilómetro Fh hora Fh segundo	LOC_NC
kilómetro Fh hora	LOC_NC
kilómetro Fh hora por segundo	LOC_NC
kilómetro Fh hora segundo	LOC_NC
kilómetro Fh segundo	LOC_NC
kilómetro Fh s	LOC_NC
kilómetro hora Fh segundo	LOC_NC
kilómetro hora por segundo	LOC_NC
kilómetro hora segundo	LOC_NC
kilómetro por hora Fh segundo	LOC_NC
kilómetro por hora	LOC_NC
kilómetro por hora por segundo	LOC_NC
kilómetro por segundo	LOC_NC
kilómetro segundo	LOC_NC
km Fh h Fh s	LOC_NCFS000
km Fh h	LOC_NCFS000
kn Fh s	LOC_NCFS000
k. o.	Y
Kublai Kan	NPMNSP0
laboratorio clínico	LOC_NC
labor docente	LOC_NCFS000
lactancia materna	LOC_NCFS000
laissez faire	NCMS000
la madre tierra	LOC_NCMS000
lapsus calami	NCMN000
lapsus linguae	NCMN000
lato sensu	LOC_ADV
laudo arbitral	LOC_NCFS000
laus Deo	LOC_ADV
lb Fh ft2	LOC_NCFP000
lb Fh ft3	LOC_NCFP000
lb Fh in2	LOC_NCFP000
lb Fh milgal	LOC_NCFP000
Lcda.	Y
Lcdo.	Y
l. c.	Y
Lda.	Y
Ldo.	Y
leche de vaca	LOC_NCFS000
lector de cd	LOC_NC
legislación autonómica	LOC_NC
legislación nacional	LOC_NC
legislación vigente	LOC_NC
legítima defensa	LOC_NCFS000
lejos de	LOC_PREP
lengua de oc	NCFS000
lengua de oíl	NCFS000
lengua extranjera	LOC_NC
lengua internacional	LOC_NC
lenguaje corporal	LOC_NCMS000
lenguaje de programación	LOC_NC
lenguaje escrito	LOC_NCMS000
lenguaje oral	LOC_NCMS000
lengua oficial	LOC_NC
lenguas de oc	NCFP000
lenguas de oíl	NCFP000
ley del suelo	LOC_NCFS000
ley de procedimiento administrativo	LOC_NCFS000
ley fundamental	LOC_NCFS000
ley general de educación	LOC_NCFS000
ley general	LOC_NCFS000
ley general presupuestaria	LOC_NCFS000
ley general tributaria	LOC_NCFS000
ley marco	LOC_NCFS000
ley orgánica del poder judicial	LOC_NCFS000
ley vigente	LOC_NC
l Fh día	LOC_NCFS000
l Fh d	LOC_NCFS000
l Fh m2 Fh d	LOC_NCFS000
l Fh m2 Fh min	LOC_NCFS000
l Fh m2 Fh s	LOC_NCFS000
l Fh m2	LOC_NCFS000
l Fh min	LOC_NCFS000
l Fh s	LOC_NCFS000
libertad de asociación	LOC_NCFS000
libertad de expresión	LOC_NCFS000
libertad de opinión	LOC_NCFS000
libertad de pensamiento	LOC_NCFS000
libertad de prensa	LOC_NCFS000
libertades fundamentales	LOC_NCFP000
libertad religiosa	LOC_NCFS000
libra Fh milgalón	LOC_NC
libra Fh pie cuadrado	LOC_NC
libra Fh pie cúbico	LOC_NC
libra Fh pulgada cuadrada	LOC_NC
libra fuerza	LOC_NC
libra milgalón	LOC_NC
libra por milgalón	LOC_NC
libra por pie cuadrado	LOC_NC
libra por pie cúbico	LOC_NC
libra por pulgada cuadrada	LOC_NC
licencia de obras	LOC_NC
Lic.	Y
liga árabe	LOC_NCFS000
lignum crucis	LOC_ADV
Lincoln Lincoln	NPCNSP0
línea de acción	LOC_NC
línea eléctrica	LOC_NC
línea fija	LOC_NCFS000
literatura juvenil	LOC_NCFS000
litro día cápita	LOC_NC
litro día per cápita	LOC_NC
litro día por cápita	LOC_NC
litro Fh día Fh cápita	LOC_NC
litro Fh día por cápita	LOC_NC
litro Fh metro cuadrado Fh dia	LOC_NC
litro Fh metro cuadrado Fh minuto	LOC_NC
litro Fh metro cuadrado Fh segundo	LOC_NC
litro Fh metro cuadrado	LOC_NC
litro Fh metro cuadrado por dia	LOC_NC
litro Fh metro cuadrado por minuto	LOC_NC
litro Fh metro cuadrado por segundo	LOC_NC
litro Fh minuto	LOC_NC
litro Fh segundo	LOC_NC
litro metro cuadrado por día	LOC_NC
litro metro cuadrado por minuto	LOC_NC
litro metro cuadrado por segundo	LOC_NC
litro por día cápita	LOC_NC
litro por día Fh cápita	LOC_NC
litro por día	LOC_NC
litro por día per cápita	LOC_NC
litro por día por cápita	LOC_NC
litro por metro cuadrado día	LOC_NC
litro por metro cuadrado Fh dia	LOC_NC
litro por metro cuadrado Fh minuto	LOC_NC
litro por metro cuadrado Fh segundo	LOC_NC
litro por metro cuadrado	LOC_NC
litro por metro cuadrado minuto	LOC_NC
litro por metro cuadrado por dia	LOC_NC
litro por metro cuadrado por minuto	LOC_NC
litro por metro cuadrado por segundo	LOC_NC
litro por metro cuadrado segundo	LOC_NC
litro por metro cuadrado y día	LOC_NC
litro por metro cuadrado y minuto	LOC_NC
litro por metro cuadrado y segundo	LOC_NC
litro por minuto	LOC_NC
litro por segundo	LOC_NC
lluvia torrencial	LOC_NC
local comercial	LOC_NC
loc. cit.	Y
loco citato	LOC_ADV
lo de menos	LOC_ADV
lo malo es que	LOC_CS
lo uno por lo otro	LOC_ADV
Ltda.	Y
Ltdo.	Y
Ltd.	Y
lt Fh d per càpita	LOC_NCFS000
lt Fh d por càpita	LOC_NCFS000
lt Fh m2 Fh d	LOC_NCFS000
lt Fh m2 Fh min	LOC_NCFS000
lt Fh m2 Fh s	LOC_NCFS000
lt Fh m2	LOC_NCFS000
lucha armada	LOC_NCFS000
lucha por el poder	LOC_NCFS000
lucro cesante	LOC_NCMS000
luego que	LOC_CS
lugar de nacimiento	LOC_NC
luz blanca	LOC_NC
L/	Y
m3 Fh ha Fh d	LOC_NCFS000
m3 Fh h	LOC_NCFS000
m3 Fh hora	LOC_NCFS000
m3 Fh m2 Fh d	LOC_NCFS000
m3 Fh m2 Fh h	LOC_NCFS000
m3 Fh seg	LOC_NCFS000
m3 Fh s	LOC_NCFS000
madre naturaleza	LOC_NCFS000
madre soltera	LOC_NC
Magallanes Magallanes	NPCNSP0
Magfca.	Y
Magfco.	Y
magister dixit	LOC_ADV
maguer que	LOC_CS
mal a mal	LOC_ADV
manu militari	LOC_ADV
mapa topográfico	LOC_NC
máquina virtual	LOC_NC
marco de referencia	LOC_NC
marco general	LOC_NCMS000
Mare Nostrum	NPMSG00
margen bruto	LOC_NCCS000
más allá de	LOC_PREP
más de la cuenta	LOC_ADV
mass media	NCMN000
mass media	NCMP000
más valiera	LOC_ADV
matemática aplicada	LOC_NC
material complementario	LOC_NC
material de oficina	LOC_NCMS000
material eléctrico	LOC_NCMS000
material escrito	LOC_NCMS000
material plástico	LOC_NCMS000
matrimonio civil	LOC_NC
máx.	Y
mea culpa	NCMN000
mecánica cuántica	LOC_NCFS000
mecánica de fluidos	LOC_NCFS000
medalla de bronce	LOC_NC
medalla de oro	LOC_NC
medalla de plata	LOC_NC
media jornada	LOC_NCFS000
mediana empresa	LOC_NCFS000
medicina de urgencias	LOC_NCFS000
medicina general	LOC_NCFS000
medicina interna	LOC_NCFS000
medicina natural	LOC_NCFS000
medicina nuclear	LOC_NCFS000
médico general	LOC_NC
médicos sin fronteras	LOC_NCMP000
medida de seguridad	LOC_NC
medio ambiente	LOC_NCMS000
medio ambiente	NCMS000
medio de transporte	LOC_NC
medio natural	LOC_NCMS000
medio rural	LOC_NCMS000
medios de comunicación de masas	LOC_NCMP000
medios de comunicación	LOC_NCMP000
medios económicos	LOC_NCMP000
medio urbano	LOC_NCMS000
memoria anual	LOC_NCFS000
memoria ram	LOC_NCFS000
memoria virtual	LOC_NCFS000
mensaje de correo electrónico	LOC_NC
mensaje de error	LOC_NC
mensaje electrónico	LOC_NC
mercado abierto	LOC_NCMS000
mercado bursátil	LOC_NC
mercado secundario	LOC_NCMS000
merced a que	LOC_CS
mesa de negociación	LOC_NC
método científico	LOC_NC
metro cuadrado	LOC_NC
metro cúbico Fh hora	LOC_NC
metro cúbico Fh segundo	LOC_NC
metro cúbico por hora	LOC_NC
metro cúbico por segundo	LOC_NC
metro Fh segundo	LOC_NC
metro Fh s	LOC_NC
metro por segundo	LOC_NC
metro segundo	LOC_NC
m Fh s	LOC_NCFS000
miembro del consejo	LOC_NC
miembro del partido	LOC_NC
miembro titular	LOC_NC
mientras que	LOC_CS
mi Fh h	LOC_NCFS000
milímetro cuadrado	LOC_NC
milímetro cúbico	LOC_NC
milímetro de hg	LOC_NC
milímetro de mercurio	LOC_NC
milla cuadrado	LOC_NC
milla Fh hora	LOC_NC
milla por hora	LOC_NC
ministerio de asuntos exteriores	LOC_NCMS000
ministerio de educación y ciencia	LOC_NCMS000
ministerio de hacienda	LOC_NCMS000
ministerio de justicia	LOC_NCMS000
ministro de asuntos exteriores	LOC_NC
ministro de hacienda	LOC_NC
ministro de obras públicas	LOC_NC
mín.	Y
mirando a	LOC_PREP
mirando hacia	LOC_PREP
misión comercial	LOC_NCFS000
mixti fori	LOC_ADV
ml Fh d	LOC_NCFS000
mlt Fh d	LOC_NCFS000
m. n.	Y
mobiliario urbano	LOC_NCFS000
modelo conceptual	LOC_NC
modelo de gestión	LOC_NC
modelo económico	LOC_NC
modelo matemático	LOC_NC
modelo oficial	LOC_NC
modelo teórico	LOC_NC
modificación de datos	LOC_NC
modus operandi	NCMN000
modus vivendi	NCMN000
moliente y corriente	AQ0CS0
moneda nacional	LOC_NCFS000
moneda única	LOC_NCFS000
monóxido de carbono	LOC_NCFS000
Mons.	Y
mortalidad infantil	LOC_NCFS000
mortis causa	LOC_ADV
motor de búsqueda	LOC_NC
motor eléctrico	LOC_NC
motu proprio	LOC_ADV
motu proprio	LOC_AQ0CN0
movilidad geográfica	LOC_NCFS000
movimiento de resistencia	LOC_NCMS000
movimiento internacional	LOC_NCMS000
movimiento nacional	LOC_NCMS000
movimiento obrero	LOC_NCMS000
movimiento revolucionario	LOC_NCMS000
mr.	Y
ms.	Y
muerte violenta	LOC_NC
muestra representativa	LOC_NCFS000
mundo material	LOC_NCMS000
música de cámara	LOC_NCFS000
música electrónica	LOC_NCFS000
música moderna	LOC_NCFS000
música popular	LOC_NCFS000
música religiosa	LOC_NCFS000
mutatis mutandis	LOC_ADV
muy de mañana	LOC_ADV
muy muy	LOC_ADV
M.	Y
m.	Y
naciones unidas	LOC_NCFP000
nada más y nada menos	LOC_ADV
N.ª S.ª	Y
naturaleza humana	LOC_NCFS000
naturaleza jurídica	LOC_NCFS000
navegación aérea	LOC_NCFS000
navegación marítima	LOC_NCFS000
N. B.	Y
N. del T.	Y
Nebrija Nebrija	NPCNSP0
necesidad básica	LOC_NC
necesidades educativas especiales	LOC_NCFP000
negociación colectiva	LOC_NCFS000
nemine discrepante	LOC_ADV
new look	LOC_AQ0CN0
new look	NCMS000
newton Fh metro cuadrado	LOC_NC
newton por metro cuadrado	LOC_NC
N Fh m2	LOC_NCMP000
ni a la de tres	LOC_ADV
ni a tiros	LOC_ADV
ni aún	LOC_ADV
ni corto ni perezoso	LOC_ADV
ni fu ni fa	LOC_ADV
ni hablar del peluquín	LOC_ADV
nihil obstat	NCMN000
ni más ni menos	LOC_ADV
ni mucho menos	LOC_ADV
ni que decir tiene	LOC_ADV
ni que	LOC_CS
ni remotamente	LOC_ADV
ni rey ni roque	LOC_ADV
ni suena ni truena	LOC_ADV
ni tan sólo	LOC_ADV
ni tanto así	LOC_ADV
ni tanto ni tan calvo	LOC_ADV
ni tanto ni tan poco	LOC_ADV
nivel de calidad	LOC_NC
nivel de confianza	LOC_NC
nivel de empleo	LOC_NCMS000
nivel de estudios	LOC_NCMS000
nivel de exigencia	LOC_NCMS000
nivel de precios	LOC_NCMS000
nivel de seguridad	LOC_NC
nivel de vida	LOC_NCMS000
nivel educativo	LOC_NCMS000
nivel técnico	LOC_NCMS000
no ha lugar	LOC_ADV
noli me tangere	LOC_ADV
nombre comercial	LOC_NC
nombre del archivo	LOC_NC
nombre de usuario	LOC_NC
non bis in idem	LOC_ADV
non plus ultra	LOC_ADV
no obstante	LOC_ADV
no obstante	LOC_CC
nora en tal	LOC_ADV
nora tal	LOC_ADV
norma básica	LOC_NC
norma jurídica	LOC_NC
normalización lingüística	LOC_NCFS000
normas de aplicación	LOC_NCFP000
normas de seguridad	LOC_NCFP000
normas sociales	LOC_NCFP000
normativa vigente	LOC_NCFS000
no sea que	LOC_CS
nota bene	NCMN000
nota media	LOC_NC
nota simple	LOC_NCFS000
n.º	Y
nro.	Y
N. S. J. C.	Y
N. S.	Y
Ntr.ª Sr.ª	Y
Ntra. Sra.	Y
núcleo familiar	LOC_NC
nueces moscadas	NCFP000
nueva economía	LOC_NCFS000
Nueva Zelanda	NPFSG00
nuez moscada	NCFS000
número de alumnos	LOC_NCMS000
número de cuenta	LOC_NCMS000
número de identificación fiscal	LOC_NCMS000
número de identificación	LOC_NCMS000
número de profesores	LOC_NCMS000
números rojos	LOC_NCMP000
numerus clausus	NCMN000
núm.	Y
n.	Y
ob. cit.	Y
obispo auxiliar	LOC_NC
obiter dictum	LOC_ADV
obra de teatro	LOC_NC
obra nueva	LOC_NCFS000
obras de infraestructura	LOC_NCFP000
obra social	LOC_NC
observatorio astronómico	LOC_NC
Ob.	Y
ocupación militar	LOC_NCFS000
oferta educativa	LOC_NCFS000
off line	LOC_ADV
oficina central	LOC_NCFS000
oficina de empleo	LOC_NC
oficina de información	LOC_NC
oficina principal	LOC_NCFS000
oficina técnica	LOC_NC
O. F. M.	Y
ola de calor	LOC_NCFS000
ola de frío	LOC_NCFS000
óleo sobre lienzo	LOC_NC
O. M.	Y
oncología médica	LOC_NCFS000
on line	LOC_ADV
onza fluido	LOC_NC
opción de compra	LOC_NC
óp. cit.	Y
operación comercial	LOC_NC
operación militar	LOC_NC
operador o	LOC_NCFS000
operador y	LOC_NCFS000
ópera prima	NCFS000
O. P.	Y
ordenación general del sistema educativo	LOC_NCFS000
ordenación urbana	LOC_NCFS000
ordenamiento jurídico	LOC_NCMS000
ordenanza fiscal	LOC_NC
ordenanza municipal	LOC_NC
orden constitucional	LOC_NCFS000
orden de prioridad	LOC_NCFS000
orden establecido	LOC_NCFS000
orden jurídico	LOC_NCFS000
orden jurisdiccional	LOC_NCFS000
orden ministerial	LOC_NCFS000
organismo oficial	LOC_NC
organización de empresas	LOC_NC
organización de las naciones unidas	LOC_NCFS000
organización de las naciones unidas para la agricultura y la alimentación	LOC_NCFS000
organización de las naciones unidas para la educación, la ciencia y la cultura	LOC_NCFS000
organización de los estados americanos	LOC_NCFS000
organización sin fines de lucro	LOC_NC
organización social	LOC_NC
órgano consultivo	LOC_NC
órgano de gobierno	LOC_NC
orientación educativa	LOC_NCFS000
O. S. A.	Y
o sea	LOC_CC
oso hormiguero	LOC_NC
óxido nítrico	LOC_NCFS000
pacto social	LOC_NCMS000
padrón municipal	LOC_NCMS000
página personal	LOC_NC
página web	LOC_NC
página web personal	LOC_NC
pago anticipado	LOC_NCMS000
pago en efectivo	LOC_NCMS000
pág.	Y
paisaje natural	LOC_NCMS000
paisaje urbano	LOC_NCMS000
país en desarrollo	LOC_NC
palacio de justicia	LOC_NCMS000
palacio de los deportes	LOC_NCMS000
pane lucrando	LOC_ADV
panem et circenses	LOC_ADV
Pange lingua	LOC_ADV
pantalla de cristal liquido	LOC_NC
pantalla de cristal líquido	LOC_NC
papel continuo	LOC_NCMS000
para colmo	LOC_ADV
para dar y tomar	LOC_ADV
parálisis cerebral	LOC_NC
para más inri	LOC_ADV
# para que	LOC_CS # see QUE Pare que sirve?
para rato	LOC_ADV
para remate	LOC_ADV
para todo trote	LOC_ADV
parecido a	LOC_PREP
parlamento europeo	LOC_NCMS000
parlamento vasco	LOC_NCMS000
parque de bomberos	LOC_NC
parque eólico	LOC_NC
párr.	Y
parte contratante	LOC_NC
partida de nacimiento	LOC_NC
partido amistoso	LOC_NC
partido comunista	LOC_NCMS000
partido conservador	LOC_NCMS000
partido de ida	LOC_NC
partido de vuelta	LOC_NC
partido liberal	LOC_NCMS000
partido oficial	LOC_NCMS000
partido político	LOC_NC
partido socialista obrero español	LOC_NCMS000
pasado mañana	LOC_ADV
pasión de cristo	LOC_NCFS000
patata frita	LOC_NC
patrimonio artístico	LOC_NC
patrimonio cultural	LOC_NC
patrimonio histórico-artístico	LOC_NC
Pat.	Y
p. a.	Y
Pbro.	Y
pdo.	Y
Pdta.	Y
Pdte.	Y
P. D.	Y
p. d.	Y
peccata minuta	LOC_ADV
peccata minuta	LOC_AQ0CN0
peccata minuta	NCFS000
p. ej.	Y
pensamiento filosófico	LOC_NCMS000
pensión de jubilación	LOC_NC
pequeña empresa	LOC_NC
pequeñas y medianas empresas	LOC_NCFP000
per accidens	LOC_ADV
per cápita	AQ0CN0
Per cápita	LOC_AQ0CN0
período de vacaciones	LOC_NC
período de validez	LOC_NCMS000
período de vigencia	LOC_NCMS000
permiso de conducir	LOC_NC
permiso de residencia	LOC_NC
per se	LOC_ADV
persona de edad avanzada	LOC_NC
personal administrativo	LOC_NCMS000
personal docente	LOC_NCMS000
personalidad jurídica	LOC_NCFS000
personalidad jurídica propia	LOC_NCFS000
persona non grata	NCFS000
perspectiva histórica	LOC_NCFS000
perspectivas económicas	LOC_NCFP000
pescado fresco	LOC_NCMS000
#pese a	LOC_PREP
pese a que	LOC_CS
Petrus in cunctis	LOC_ADV
pg.	Y
pian pianito	LOC_ADV
pian pian	LOC_ADV
pian piano	LOC_ADV
pie cuadrado	LOC_NC
pie cúbico Fh minuto	LOC_NC
pie cúbico Fh segundo	LOC_NC
pie cúbico	LOC_NC
pie cúbico por minuto	LOC_NC
pie cúbico por segundo	LOC_NC
pie de agua	LOC_NC
pie Fh hora	LOC_NC
pie Fh minuto	LOC_NC
pie Fh segundo Fh segundo	LOC_NC
pie Fh segundo	LOC_NC
pie Fh segundo por segundo	LOC_NC
pie Fh segundo segundo	LOC_NC
pie hora	LOC_NC
pie minuto	LOC_NC
pie por hora	LOC_NC
pie por minuto	LOC_NC
pie por segundo al cuadrado	LOC_NC
pie por segundo cuadrado	LOC_NC
pie por segundo Fh segundo	LOC_NC
pie por segundo	LOC_NC
pie por segundo por segundo	LOC_NC
pie por segundo segundo	LOC_NC
pie segundo Fh segundo	LOC_NC
pie segundo	LOC_NC
pie segundo por segundo	LOC_NC
pie segundo segundo	LOC_NC
piscina cubierta	LOC_NC
p. k.	Y
plan de emergencia	LOC_NC
plan de gestión	LOC_NC
plan general de contabilidad	LOC_NCMS000
planificación económica	LOC_NCFS000
planificación familiar	LOC_NCFS000
plano de situación	LOC_NCMS000
play back	NCMN000
play boy	NCMS000
play boys	NCMP000
plazo de admisión	LOC_NC
pleno del ayuntamiento	LOC_NC
pleno empleo	LOC_NCMS000
pleno municipal	LOC_NC
plis plas	NCMS000
pluralia tantum	LOC_ADV
plus minusve	LOC_ADV
plus ultra	LOC_ADV
pl.	Y
plza.	Y
P. M.	Y
p. m.	Y
Pnt.	Y
población objetivo	LOC_NCFS000
poco a poco	LOC_ADV
policía judicial	LOC_NCCS000
polígono industrial	LOC_NC
política ambiental	LOC_NC
política de defensa	LOC_NC
política de empleo	LOC_NC
política económica	LOC_NC
pop art	AQ0CN0
por adarmes	LOC_ADV
por al lado de	LOC_PREP
por amor de Dios	LOC_ADV
por anticipado	LOC_ADV
por aquel entonces	LOC_ADV
por arte de birlibirloque	LOC_ADV
por arte de magia	LOC_ADV
por barba	LOC_ADV
por carambola	LOC_ADV
por causa de	LOC_PREP
por ce o por be	LOC_ADV
por ceremonia	LOC_ADV
por concuerda	LOC_ADV
por consecuencia	LOC_ADV
por consiguiente	LOC_ADV
por contera	LOC_ADV
por cuatro reales	LOC_ADV
por cuenta de	LOC_PREP
por cuenta y riesgo	LOC_ADV
por debajo de cuerda	LOC_ADV
por debajo de	LOC_PREP
por decirlo así	LOC_ADV
por de contado	LOC_ADV
por delante de	LOC_PREP
por dentro de	LOC_PREP
por de pronto	LOC_ADV
por descontado	LOC_ADV
por detrás de	LOC_PREP
por duplicado	LOC_ADV
por ejemplo	LOC_ADV
por el centro de	LOC_PREP
por el contrario	LOC_ADV
por el otro lado de	LOC_PREP
por ende	LOC_ADV
por en medio	LOC_ADV
por ensalmo	LOC_ADV
por entonces	LOC_ADV
por esos mundos de Dios	LOC_ADV
por este lado de	LOC_PREP
por favor	LOC_ADV
por hache o por be	LOC_ADV
por igual	LOC_ADV
por intuito	LOC_ADV
por la cuenta que	LOC_CS
por la gracia de Dios	LOC_ADV
por lo bajines	LOC_ADV
por lo bajini	LOC_ADV
por lo bajinis	LOC_ADV
por lo claro	LOC_ADV
por lo común	LOC_ADV
por lo general	LOC_ADV
por lo menos	LOC_ADV
por lo presente	LOC_ADV
por lo pronto	LOC_ADV
por lo tanto	LOC_ADV
por más que digas	LOC_ADV
por medio de	LOC_PREP
por minutos	LOC_ADV
por motivo de	LOC_PREP
por mucho que	LOC_CS
por nada del mundo	LOC_ADV
por ningún concepto	LOC_ADV
por norma general	LOC_ADV
por obra de	LOC_PREP
por obra y gracia de	LOC_PREP
por oídas	LOC_ADV
por onzas	LOC_ADV
por otro lado	LOC_ADV
por pura fórmula	LOC_ADV
por razón de que	LOC_CS
por real decreto	LOC_ADV
por regla general	LOC_ADV
por segundo año consecutivo	LOC_ADV
por separado	LOC_ADV
por si acaso	LOC_ADV
por siempre jamás	LOC_ADV
por si las moscas	LOC_ADV
por supuesto	LOC_ADV
por testa	LOC_ADV
por todo lo alto	LOC_ADV
por un tris	LOC_ADV
por ventura	LOC_ADV
por virtud de	LOC_PREP
post meridiem	LOC_ADV
post mortem	LOC_ADV
post scriptum	LOC_ADV
potencia de salida	LOC_NCFS000
potestad sancionadora	LOC_NCFS000
p/o	Y
p. o.	Y
P. O.	Y
p.º	Y
ppal.	Y
p. p.	Y
práctica clínica	LOC_NC
prae manibus	LOC_ADV
pral.	Y
precio de mercado	LOC_NCMS000
precio máximo	LOC_NCMS000
precio mínimo	LOC_NCMS000
precio único	LOC_NCMS000
precio unitario	LOC_NCMS000
predicción del tiempo	LOC_NC
predicción meteorológica	LOC_NC
preparador físico	LOC_NC
Presb.	Y
presidencia del gobierno	LOC_NCFS000
presidente del consejo de administración	LOC_NC
presidente del parlamento	LOC_NCMS000
presión sanguínea	LOC_NCFS000
préstamo hipotecario	LOC_NC
presupuesto aprobado	LOC_NC
presupuesto nacional	LOC_NC
prevención de riesgos laborales	LOC_NCFS000
prevención de riesgos	LOC_NCFS000
prima donna	NCFN000
prima facie	LOC_ADV
primera comunión	LOC_NCFS000
primera guerra mundial	LOC_NCFS000
primer ministro	LOC_NC
primero de mayo	LOC_NCMS000
primeros auxilios	LOC_NCMP000
primus inter pares	NCMS000
principio de igualdad	LOC_NCMS000
principio de legalidad	LOC_NCMS000
principios generales del derecho	LOC_NCMP000
procedimiento administrativo	LOC_NC
procedimiento de evaluación	LOC_NC
procedimiento judicial	LOC_NC
procesamiento de la información	LOC_NCMP000
proceso administrativo	LOC_NC
proceso de datos	LOC_NCMS000
proceso de desarrollo	LOC_NCMS000
proceso de fabricación	LOC_NCMS000
proceso de integración	LOC_NCMS000
proceso de socialización	LOC_NCMS000
proceso educativo	LOC_NCMS000
pro domo sua	LOC_ADV
producción agrícola	LOC_NC
producción cinematográfica	LOC_NC
producción editorial	LOC_NC
producción editorial	LOC_NCFS000
producto bruto	LOC_NCMS000
producto nacional	LOC_NC
producto químico	LOC_NC
Prof.ª	Y
profesor emérito	LOC_NC
profesor titular	LOC_NC
pro forma	LOC_ADV
Prof.	Y
programación general	LOC_NCMS000
programa de las naciones unidas para el medio ambiente	LOC_NCMS000
programa gratuito	LOC_NC
progreso económico	LOC_NCMS000
pról.	Y
promoción del empleo	LOC_NCFS000
promulgación de la ley	LOC_NCFS000
propiedad urbana	LOC_NCFS000
proposición de ley	LOC_NCFS000
proposición no de ley	LOC_NCFS000
propter nuptias	LOC_ADV
prosperidad económica	LOC_NCFS000
protocolo de kioto	LOC_NCMS000
protocolo tcp-ip	LOC_NCFS000
protocolo tcp/ip	LOC_NCFS000
prov.	Y
proyecto de ley	LOC_NC
proyecto empresarial	LOC_NC
prueba documental	LOC_NC
psicología aplicada	LOC_NCFS000
psicología clínica	LOC_NCFS000
psicología cognitiva	LOC_NCFS000
psicología evolutiva	LOC_NCFS000
psicología general	LOC_NCFS000
psicología social	LOC_NCFS000
P. S.	Y
publicidad comercial	LOC_NCFS000
pues bien	LOC_ADV
pues sí que	LOC_CS
pues sí que	LOC_I
puesta en servicio	LOC_NCFS000
pulgada agua	LOC_NC
pulgada cuadrado	LOC_NC
pulgada cúbico	LOC_NC
pulgada de agua	LOC_NC
pulgada de hg	LOC_NC
pulgada Fh segundo Fh segundo	LOC_NC
pulgada Fh segundo por segundo	LOC_NC
pulgada Fh segundo segundo	LOC_NC
pulgada hg	LOC_NC
pulgada por segundo al cuadrado	LOC_NC
pulgada por segundo cuadrado	LOC_NC
pulgada por segundo Fh segundo	LOC_NC
pulgada por segundo por segundo	LOC_NC
pulgada por segundo segundo	LOC_NC
pulgada segundo Fh segundo	LOC_NC
pulgada segundo por segundo	LOC_NC
pulgada segundo segundo	LOC_NC
punto crítico	LOC_NC
punto de cruz	LOC_NCMS000
punto de equilibrio	LOC_NCMS000
punto de partida	LOC_NCMS000
punto de referencia	LOC_NCMS000
punto focal	LOC_NCMS000
puntuación media	LOC_NCMS000
P. V. P.	Y
p. v.	Y
P.	Y
p.	Y
pza.	Y
q. b. s. m.	Y
q. b. s. p.	Y
q. D. g.	Y
Q. D. G.	Y
q. e. g. e.	Y
q. e. p. d.	Y
q. e. s. m.	Y
q. s. g. h.	Y
que ni hecho de encargo	LOC_ADV
que ni pintado	LOC_ADV
que pela	LOC_ADV
que si tal que si cual	LOC_ADV
queso fresco	LOC_NC
quid divinum	LOC_ADV
quid pro quo	LOC_ADV
quiera que no	LOC_ADV
quieras que no	LOC_ADV
química ambiental	LOC_NCFS000
química general	LOC_NCMS000
química industrial	LOC_NCMS000
rabassa morta	LOC_ADV
rad Fh s	LOC_NCFS000
radiación solar	LOC_NC
radiación ultravioleta	LOC_NC
radián Fh segundo	LOC_NC
radián por segundo	LOC_NC
ramo de flores	LOC_NC
rara avis	NCCN000
rara vez	LOC_ADV
rata parte	LOC_ADV
rayos x	LOC_NCMP000
Rda.	Y
Rdo.	Y
R. D.	Y
reacción química	LOC_NC
real decreto ley	LOC_NCMS000
reales decretos leyes	NCMS000
reality show	NCMS000
reality shows	NCMP000
recaudación de impuestos	LOC_NCMS000
reconocimiento de voz	LOC_NCMS000
recurso administrativo	LOC_NC
recursos hídricos	LOC_NCMP000
recursos públicos	LOC_NCMP000
red de datos	LOC_NCFS000
red de relaciones	LOC_NCFS000
red ethernet	LOC_NCFS000
red informática	LOC_NCFS000
red privada	LOC_NCFS000
red pública	LOC_NCFS000
red telefónica	LOC_NCFS000
reducción de jornada	LOC_NCFS000
reducción de la jornada	LOC_NCFS000
reforma constitucional	LOC_NC
reforma tributaria	LOC_NC
régimen capitalista	LOC_NCMS000
régimen democrático	LOC_NCMS000
régimen disciplinario	LOC_NCMS000
régimen económico	LOC_NCMS000
régimen general de la seguridad social	LOC_NCMS000
régimen jurídico	LOC_NCMS000
régimen político	LOC_NCMS000
régimen tributario	LOC_NCMS000
registro de datos	LOC_NC
regla de oro	LOC_NC
regresión lineal	LOC_NCFS000
reg.	Y
reino animal	LOC_NCMS000
reinserción social	LOC_NCMS000
relación bilateral	LOC_NCFS000
relación de dependencia	LOC_NCFS000
relaciones de producción	LOC_NCFP000
relaciones diplomáticas	LOC_NCFP000
relaciones humanas	LOC_NCFP000
relación jurídica	LOC_NCFS000
relación personal	LOC_NC
relata refero	LOC_ADV
relata réfero	LOC_ADV
rendimiento escolar	LOC_NCMS000
rentabilidad económica	LOC_NC
renta variable	LOC_NC
representación diplomática	LOC_NC
representación gráfica	LOC_NC
representación legal	LOC_NC
representación proporcional	LOC_NCFS000
representante del gobierno	LOC_NC
reproducción asistida	LOC_NCFS000
reproductor de dvd	LOC_NC
república federal	LOC_NCFS000
Rep.	Y
requiescat in pace	LOC_ADV
reserva de la biosfera	LOC_NC
reserva legal	LOC_NCFS000
residencia habitual	LOC_NCFS000
residencia oficial	LOC_NC
resistencia de materiales	LOC_NCFS000
resolución administrativa	LOC_NC
resolución impugnada	LOC_NC
respecto a	LOC_PREP
respecto a que	LOC_CS
respecto de	LOC_PREP
responsabilidad administrativa	LOC_NC
responsabilidad civil	LOC_NC
resultado oficial	LOC_NC
retraso mental	LOC_NCMS000
revolución cultural	LOC_NCFS000
revolución francesa	LOC_NCFS000
revolución socialista	LOC_NCFS000
Rev.	Y
riesgo social	LOC_NC
rigor científico	LOC_NCMS000
rigor mortis	NCMN000
río abajo	LOC_ADV
río arriba	LOC_ADV
Río de Janeiro	NPCSG00
R. I. P.	Y
ritmo cardiaco	LOC_NCMS000
ritmo de trabajo	LOC_NCMS000
rock and roll	LOC_NCMS000
rock and roll	NCMS000
rock 'n' roll	NCMS000
rock'n'roll	NCMS000
rock & roll	NCMS000
rock&roll	NCMS000
role playing	LOC_NCMS000
roll on	LOC_AQ0CN0
R. O.	Y
r.º	Y
r.p.m.	NCFN000
r. p. m.	Y
RR. HH.	Y
Rte.	Y
rum rum	NCMS000
Rvda.	Y
Rvdma.	Y
Rvdmo.	Y
Rvdo.	Y
Rvd.	Y
R.	Y
sábado santo	LOC_NCMS000
sagrada familia	LOC_NCMS000
S. A. I.	Y
sala de prensa	LOC_NC
salario base	LOC_NC
salario mínimo	LOC_NC
salga lo que salga	LOC_ADV
salón de plenos	LOC_NC
salsa de tomate	LOC_NC
salud ambiental	LOC_NCFS000
salud bucodental	LOC_NCFS000
San Cristóbal y Nieves	NPCSG00
santa misa	LOC_NCFS000
Sant Cugat del Vallès	NPCSG00
Sant Cugat	NPCSG00
santísima trinidad	LOC_NCMS000
santísimo sacramento	LOC_NCMS000
Sant Joan Despí	NPCSG00
santo oficio	LOC_NCMS000
santo sepulcro	LOC_NCMS000
S. A. R.	Y
S. A. S.	Y
s/a	Y
S. A.	Y
s. a.	Y
S.ª	Y
s/c	Y
s. c.	Y
Sdad.	Y
S. D. M.	Y
s. d.	Y
sea cual fuere	LOC_ADV
sea lo que fuere	LOC_ADV
secretaría de estado	LOC_NCFS000
secretaría de gobierno	LOC_NCFS000
secretaría general	LOC_NCFS000
sector agrario	LOC_NCMS000
sector agrícola	LOC_NCMS000
sector económico	LOC_NCMS000
sector turístico	LOC_NCMS000
según como	LOC_ADV
segunda guerra mundial	LOC_NCFS000
segunda lengua	LOC_NC
según el decir de	LOC_PREP
según que	LOC_CS
seguridad del estado	LOC_NCFS000
seguridad e higiene	LOC_NCFS000
seguridad internacional	LOC_NCFS000
seguridad jurídica	LOC_NCFS000
seguridad personal	LOC_NCFS000
seguro de accidentes	LOC_NC
seguro de vida	LOC_NC
seguro obligatorio	LOC_NC
seguro social	LOC_NC
selección nacional	LOC_NC
selección natural	LOC_NCFS000
selva tropical	LOC_NC
semejante a	LOC_PREP
sensu lato	LOC_ADV
sensu stricto	LOC_ADV
sentencia firme	LOC_NCFS000
sentido contrario	LOC_NCMS000
sentido crítico	LOC_NCMS000
sentido del humor	LOC_NCMS000
sentido de responsabilidad	LOC_NCMS000
sentido literal	LOC_NCMS000
sentimiento de culpa	LOC_NC
separación de poderes	LOC_NCFS000
servicio asistencial	LOC_NC
servicio de apoyo	LOC_NC
servicio de atención al cliente	LOC_NC
servicio de información	LOC_NC
servicio de urgencias	LOC_NC
servicio educativo	LOC_NC
servicio jurídico	LOC_NC
servicio meteorológico	LOC_NC
servicio público	LOC_NC
servicios funerarios	LOC_NCMP000
servicios sociales	LOC_NCMP000
servicios urbanos	LOC_NCMP000
servicio turístico	LOC_NC
servidor dns	LOC_NC
servidor proxy	LOC_NC
servidor web	LOC_NC
sesión continua	LOC_NC
sesión plenaria	LOC_NC
s. e. u o.	Y
sex appeal	NCMS000
sex shop	NCMS000
sex symbol	NCMS000
sex symbols	NCMP000
s/e	Y
S. E.	Y
s. e.	Y
s/f	Y
s. f.	Y
Sgto.	Y
show business	NCMS000
si acaso	LOC_ADV
si bien se mira	LOC_ADV
siempre y cuando	LOC_CS
# siendo así	LOC_ADV # QUE[5]
sig.	Y
silencio administrativo	LOC_NCMS000
similar a	LOC_PREP
sin ambages	LOC_ADV
sin chistar ni mistar	LOC_ADV
sin comerlo ni beberlo	LOC_ADV
sin contar con	LOC_PREP
sin contar con que	LOC_CS
síndrome de down	LOC_NCMS000
sin duda alguna	LOC_ADV
sine die	LOC_ADV
sine qua non	LOC_ADV
singularia tantum	LOC_ADV
sin ir más lejos	LOC_ADV
sin lugar a dudas	LOC_ADV
sin más ni más	LOC_ADV
sin necesidad de	LOC_PREP
sin ninguna duda	LOC_ADV
si no es por	LOC_PREP
si no es que	LOC_CC
sino que	LOC_CC
sin pena ni gloria	LOC_ADV
sin perjuicio de	LOC_PREP
sin qué ni para qué	LOC_ADV
sin ton ni son	LOC_ADV
sin trastes	LOC_ADV
sin venir a pelo	LOC_ADV
sistema abierto	LOC_NCMS000
sistema de clasificación	LOC_NC
sistema de comunicación	LOC_NC
sistema de correo	LOC_NC
sistema de defensa	LOC_NC
sistema de ficheros	LOC_NC
sistema de gestión	LOC_NC
sistema de gobierno	LOC_NC
sistema de información geográfica	LOC_NC
sistema de juego	LOC_NC
sistema de medición	LOC_NC
sistema democrático	LOC_NC
sistema de partidos	LOC_NC
sistema de producción	LOC_NC
sistema de seguridad	LOC_NC
sistema económico	LOC_NC
sistema educativo	LOC_NC
sistema electoral	LOC_NC
sistema electrónico	LOC_NC
sistema federal	LOC_NC
sistema fiscal	LOC_NC
sistema informático	LOC_NC
sistema métrico	LOC_NCMS000
sistema nacional de salud	LOC_NCMS000
sistema nervioso central	LOC_NCMS000
sistema nervioso	LOC_NCMS000
sistema social	LOC_NCMS000
sistema tributario	LOC_NCMS000
sitio web	LOC_NC
situación administrativa	LOC_NCFS000
situación de emergencia	LOC_NC
situación económica	LOC_NCFS000
situación financiera	LOC_NCFS000
situación jurídica	LOC_NCFS000
S. I.	Y
S. J.	Y
s/l	Y
S. L.	Y
s. l.	Y
S. M.	Y
snack bar	NCMS000
snack bars	NCMP000
s/n	Y
s. n.	Y
soberanía nacional	LOC_NCFS000
soberanía popular	LOC_NCFS000
sobre manera	LOC_ADV
sobre seguro	LOC_ADV
sociedad capitalista	LOC_NC
sociedad financiera	LOC_NC
socio fundador	LOC_NC
sociología política	LOC_NCFS000
Soc.	Y
software educativo	LOC_NC
solidaridad internacional	LOC_NCFS000
so pena de que	LOC_CS
so pena que	LOC_CS
soporte físico	LOC_NC
sotto voce	LOC_ADV
# Spanish multiwords file used for chunking
S. P.	Y
Sr.ª	Y
Sra.	Y
S. R. C.	Y
Sri Lanka	NPCSG00
S. R. M.	Y
Srta.	Y
Sr.	Y
s. s. s.	Y
S. S.	Y
s. s.	Y
stabat mater	NCMN000
statu quo	NCMN000
Sta.	Y
Sto.	Y
stricto sensu	LOC_ADV
sub iudice	LOC_ADV
sub judice	LOC_ADV
subsecretario de estado	LOC_NC
sub voce	LOC_ADV
suelo no urbanizable	LOC_NCMS000
suelo urbanizable	LOC_NCMS000
sui géneris	LOC_ADV
suministro de energía eléctrica	LOC_NC
súper 8	LOC_NCFS000
superficie plana	LOC_NC
superficie útil	LOC_NCFS000
supuesto que	LOC_CS
sustancia química	LOC_NC
s/v	Y
s. v.	Y
S.	Y
s.	Y
tabula gratulatoria	NCFS000
tabula rasa	NCFS000
tal como	LOC_CS
tal cual	LOC_ADV
taller mecánico	LOC_NC
tal vez	LOC_ADV
tal y como	LOC_CS
tamaño de la población	LOC_NCMS000
tamaño natural	LOC_NCMS000
tan pronto como	LOC_CS
tan siquiera	LOC_ADV
tanto más que	LOC_CS
tanto menos que	LOC_CS
tanto peor	LOC_ADV
tanto por ciento	LOC_ADV
tanto por tanto	LOC_ADV
Tantum ergo	NCMS000
tarjeta de identificación	LOC_NC
tarjeta de red	LOC_NC
tarjeta de sonido	LOC_NC
tarjeta de vídeo	LOC_NC
tarjeta gráfica	LOC_NC
tarjeta pcmcia	LOC_NC
tarjeta roja	LOC_NC
tasa de cambio	LOC_NC
tasa de crecimiento	LOC_NC
tasa de desempleo	LOC_NC
tasa de inflación	LOC_NC
tasa de paro	LOC_NC
taza de café	LOC_NC
técnica de evaluación	LOC_NC
técnica mixta	LOC_NC
técnico auxiliar	LOC_NC
técnico económico	LOC_NC
tecnología avanzada	LOC_NCFS000
tecnología educativa	LOC_NCFS000
tejido adiposo	LOC_NCMS000
tejido conectivo	LOC_NCMS000
telefonía ip	LOC_NCMS000
teléf.	Y
televisión educativa	LOC_NCFS000
tel.	Y
tema de investigación	LOC_NC
temperatura del agua	LOC_NCFS000
temperatura extrema	LOC_NC
tensión arterial	LOC_NCFS000
teoría crítica	LOC_NCFS000
teoría de la comunicación	LOC_NCFS000
teoría de la relatividad	LOC_NCFS000
teoría económica	LOC_NC
teoría política	LOC_NC
terapia física	LOC_NCFS000
terapia ocupacional	LOC_NCFS000
tercera división	LOC_NCFS000
tercera edad	LOC_NCFS000
terreno de juego	LOC_NC
territorio nacional	LOC_NCMS000
tesis doctoral	LOC_NC
testigo de jehová	LOC_NC
test.º	Y
té verde	LOC_NCMS000
texto legal	LOC_NC
texto original	LOC_NC
tfno.	Y
tie break	NCMS000
tie breaks	NCMP000
tiempo de exposición	LOC_NCMS000
tiempo de servicio	LOC_NCMS000
tienda especializada	LOC_NC
tierra adentro	LOC_ADV
tipo de cambio	LOC_NC
tipo de datos	LOC_NC
tipo de trabajo	LOC_NC
tipo de vegetación	LOC_NC
tira cómica	LOC_NC
tiro libre	LOC_NCMS000
titulación académica	LOC_NC
título académico	LOC_NC
título de bachiller	LOC_NC
título de propiedad	LOC_NC
título oneroso	LOC_NCMS000
título preliminar	LOC_NCMS000
título profesional	LOC_NC
título superior	LOC_NCMS000
tít.	Y
todo lo contrario	LOC_ADV
todo lo contrario	LOC_I
todo oídos	LOC_ADV
todo quisque	NCMS000
toga picta	LOC_ADV
toma de decisiones	LOC_NCFS000
tonelada métrico	LOC_NC
tono de voz	LOC_NC
tono muscular	LOC_NCMS000
top model	NCCS000
top models	NCCP000
totum revolutum	NCMS000
tour de force	NCMS000
trabajo asalariado	LOC_NCMS000
trabajo de campo	LOC_NC
trabajo doméstico	LOC_NC
trabajo en grupo	LOC_NC
trabajo grupal	LOC_NCMS000
trabajo nocturno	LOC_NC
trabajos forzados	LOC_NCMP000
tracto gastrointestinal	LOC_NCMS000
traducción automática	LOC_NCFS000
trad.	Y
tráfico de drogas	LOC_NCMS000
transacción comercial	LOC_NC
transferencia de datos	LOC_NC
transferencia de información	LOC_NCFS000
transmisión de datos	LOC_NC
transporte aéreo	LOC_NC
transporte de viajeros	LOC_NCMS000
transporte público	LOC_NCMS000
tratado de la unión europea	LOC_NCMS000
tratado de paz	LOC_NC
tratamiento de aguas residuales	LOC_NCMS000
tratamiento de datos	LOC_NCMS000
tratamiento de imágenes	LOC_NCMS000
tratamiento térmico	LOC_NCMS000
tribunal de apelación	LOC_NC
tribunal superior de justicia	LOC_NCMS000
Trinidad y Tobago	NPCSG00
Tte.	Y
tumor cerebral	LOC_NC
turismo activo	LOC_NCMS000
tutti quanti	LOC_ADV
t.	Y
Uds.	Y
Ud.	Y
una vez que	LOC_CS
una y no más	LOC_ADV
un día u otro	LOC_ADV
un día y otro	LOC_ADV
unidad administrativa	LOC_NC
unidad de control	LOC_NC
unidad de cuidados intensivos	LOC_NCFS000
unidad de gestión	LOC_NC
unidad de información	LOC_NC
unidad de masa atómica	LOC_NC
unidad de medida	LOC_NC
unidad de producción	LOC_NC
unidad de tiempo	LOC_NC
unidad didáctica	LOC_NC
unidad familiar	LOC_NCFS000
unión aduanera	LOC_NCFS000
unión económica	LOC_NCFS000
unión económica y monetaria	LOC_NCFS000
unión europea	LOC_NCFS000
unión general de trabajadores	LOC_NCFS000
universidad del país vasco	LOC_NCFS000
universidad nacional de educación a distancia	LOC_NCFS000
Univ.	Y
uno por uno	LOC_ADV
un poco tarde	LOC_ADV
urbi et orbi	LOC_ADV
urbi et orbi	LOC_AQ0CN0
uso privado	LOC_NCMS000
uso residencial	LOC_NCMS000
usuario registrado	LOC_NC
utilidad pública	LOC_NCFS000
ut retro	LOC_ADV
ut supra	LOC_ADV
U.	Y
vade retro	LOC_ADV
vae victis	LOC_ADV
Valmte.	Y
valor absoluto	LOC_NC
valor artístico	LOC_NCMS000
valor de mercado	LOC_NC
valor económico	LOC_NCMS000
valores mobiliarios	LOC_NCMP000
valor estimado	LOC_NCMS000
valor inicial	LOC_NC
valor medio	LOC_NCMS000
valor nominal	LOC_NCMS000
valor numérico	LOC_NCMS000
valor probatorio	LOC_NCMS000
valor social	LOC_NCMS000
vapor de agua	LOC_NCMS000
varita mágica	LOC_NC
V. A. R.	Y
vaso de vino	LOC_NC
V. A.	Y
vaya por dios	LOC_I
vaya por Dios	LOC_I
V. B.	Y
Vda.	Y
Vdo.	Y
Vds.	Y
Vd.	Y
velis nolis	LOC_ADV
velocidad de la luz	LOC_NCFS000
velocidad del viento	LOC_NCFS000
velocidad de transferencia	LOC_NCFS000
velocidad de transmisión	LOC_NCFS000
velocidad máxima	LOC_NCFS000
venta de acciones	LOC_NC
venta directa	LOC_NC
vera effigies	LOC_ADV
verbi gratia	LOC_ADV
V. E.	Y
v Fh m	LOC_NCFS000
v. gr.	Y
v. g.	Y
viabilidad económica	LOC_NCFS000
vía crucis	NCMN000
vía férrea	LOC_NC
viaje de ida	LOC_NC
vía respiratoria	LOC_NC
vicario general	LOC_NC
vida en sociedad	LOC_NCFS000
vida profesional	LOC_NCFS000
vídeo vhs	LOC_NCMS000
vid.	Y
villa olímpica	LOC_NCFS000
violencia doméstica	LOC_NCFS000
violencia familiar	LOC_NCFS000
virus de la inmunodeficiencia humana	LOC_NCMN000
vitamina a	LOC_NCFS000
vitamina c	LOC_NCFS000
vitamina d	LOC_NCFS000
vitamina e	LOC_NCFS000
viva voce	LOC_ADV
vivienda habitual	LOC_NCFS000
vivienda social	LOC_NCFS000
V. I.	Y
V. M.	Y
V.º B.º	Y
volt Fh metro	LOC_NC
volt por metro	LOC_NC
volumen de negocios	LOC_NCMS000
volumen de trabajo	LOC_NCMS000
voluntariado social	LOC_NCMS000
vol.	Y
V. O. S.	Y
voto a bríos	LOC_ADV
voto particular	LOC_NCMS000
vox populi	LOC_ADV
vox populi	NCFS000
V. O.	Y
v.º	Y
V. P.	Y
V. S. I.	Y
V. S.	Y
vs.	Y
vta.	Y
vto.	Y
vv. aa.	Y
VV. AA.	Y
v/	Y
v.	Y
V.	Y
watt Fh estereoradián	LOC_NC
watt Fh metro Fh grado kelvin	LOC_NC
watt Fh metro Fh kelvin	LOC_NC
watt Fh metro por grado kelvin	LOC_NC
watt Fh metro por kelvin	LOC_NC
watt por estereoradián	LOC_NC
watt por metro Fh grado kelvin	LOC_NC
watt por metro Fh kelvin	LOC_NC
watt por metro por grado kelvin	LOC_NC
watt por metro por kelvin	LOC_NC
W. C.	Y
w Fh m K	LOC_NCFS000
w Fh srad	LOC_NCFS000
wi fi	NCMN000
wind surfing	NCMS000
wind surf	NCMS000
Xto.	Y
ya es mucho decir	LOC_ADV
ya que	LOC_CS
yarda cuadrado	LOC_NC
yarda cúbico	LOC_NC
ya será menos	LOC_ADV
zona arqueológica	LOC_NC
zona comercial	LOC_NC
zona de descanso	LOC_NC
zona de libre comercio	LOC_NCFS000
zona de trabajo	LOC_NC
zona franca	LOC_NCFS000
zona horaria	LOC_NCFS000
zona privada	LOC_NC
zona residencial	LOC_NC
zona restringida	LOC_NC
zona turística	LOC_NC

